Año,Mes,Mes_Num,Fecha,Nacionalidad,Femenino,Masculino,Indefinido,Total
2012,Enero,1,1/1/2012,Islas Alboran y Perejil,1,0,0,1
2012,Enero,1,1/1/2012,Albania,1,2,0,3
2012,Enero,1,1/1/2012,Alemania,1396,2439,0,3835
2012,Enero,1,1/1/2012,Andorra,6,11,0,17
2012,Enero,1,1/1/2012,Angola,1,1,0,2
2012,Enero,1,1/1/2012,Antigua y Barbuda,1,1,0,2
2012,Enero,1,1/1/2012,Países Bajos,798,1418,0,2216
2012,Enero,1,1/1/2012,Argelia,3,4,0,7
2012,Enero,1,1/1/2012,Argentina,5696,6082,0,11778
2012,Enero,1,1/1/2012,Aruba,0,2,0,2
2012,Enero,1,1/1/2012,Australia,379,678,0,1057
2012,Enero,1,1/1/2012,Austria,151,328,0,479
2012,Enero,1,1/1/2012,Azerbaiyán,1,2,0,3
2012,Enero,1,1/1/2012,Bahamas,2,5,0,7
2012,Enero,1,1/1/2012,Bahréin,0,1,0,1
2012,Enero,1,1/1/2012,Bangladesh,0,1,0,1
2012,Enero,1,1/1/2012,Barbados,3,3,0,6
2012,Enero,1,1/1/2012,República de Belarús,5,5,0,10
2012,Enero,1,1/1/2012,Bélgica,172,380,0,552
2012,Enero,1,1/1/2012,Belice,9,11,0,20
2012,Enero,1,1/1/2012,Bermudas/Territorio Británico de Ultramar,0,2,0,2
2012,Enero,1,1/1/2012,Bolivia,404,512,0,916
2012,Enero,1,1/1/2012,Bosnia y Herzegovina,0,1,0,1
2012,Enero,1,1/1/2012,Botsuana,0,1,0,1
2012,Enero,1,1/1/2012,Brasil,4231,5579,0,9810
2012,Enero,1,1/1/2012,Bulgaria,8,13,0,21
2012,Enero,1,1/1/2012,Burkina Faso,1,0,0,1
2012,Enero,1,1/1/2012,Islas Caimán/Territorio Británico de Ultramar,2,8,0,10
2012,Enero,1,1/1/2012,Camerún,1,2,0,3
2012,Enero,1,1/1/2012,Canadá,2785,3644,0,6429
2012,Enero,1,1/1/2012,Chad,0,2,0,2
2012,Enero,1,1/1/2012,España,2381,5165,0,7546
2012,Enero,1,1/1/2012,República Democrática del Congo,0,3,0,3
2012,Enero,1,1/1/2012,República de Corea,145,344,0,489
2012,Enero,1,1/1/2012,Costa de Marfil,1,1,0,2
2012,Enero,1,1/1/2012,Costa Rica,960,1107,0,2067
2012,Enero,1,1/1/2012,Croacia,11,18,0,29
2012,Enero,1,1/1/2012,Cuba,172,282,0,454
2012,Enero,1,1/1/2012,Curazao,1,1,0,2
2012,Enero,1,1/1/2012,República Checa,54,82,0,136
2012,Enero,1,1/1/2012,Chile,2251,3278,0,5529
2012,Enero,1,1/1/2012,China,113,264,0,377
2012,Enero,1,1/1/2012,Chipre,1,2,0,3
2012,Enero,1,1/1/2012,Dinamarca,72,171,0,243
2012,Enero,1,1/1/2012,Dominica,1,5,0,6
2012,Enero,1,1/1/2012,Ecuador,3068,4894,0,7962
2012,Enero,1,1/1/2012,Egipto,0,9,0,9
2012,Enero,1,1/1/2012,El Salvador,373,554,0,927
2012,Enero,1,1/1/2012,Eslovaquia,16,37,0,53
2012,Enero,1,1/1/2012,Eslovenia,35,43,0,78
2012,Enero,1,1/1/2012,Estados Unidos de América,6889,14798,0,21687
2012,Enero,1,1/1/2012,Estonia,10,14,0,24
2012,Enero,1,1/1/2012,Etiopia,0,2,0,2
2012,Enero,1,1/1/2012,Filipinas,28,146,0,174
2012,Enero,1,1/1/2012,Finlandia,270,289,0,559
2012,Enero,1,1/1/2012,Francia,1319,2117,0,3436
2012,Enero,1,1/1/2012,Gabón,0,1,0,1
2012,Enero,1,1/1/2012,Georgia,1,0,0,1
2012,Enero,1,1/1/2012,Ghana,0,5,0,5
2012,Enero,1,1/1/2012,Granada,0,1,0,1
2012,Enero,1,1/1/2012,Grecia,13,97,0,110
2012,Enero,1,1/1/2012,Guatemala,209,405,0,614
2012,Enero,1,1/1/2012,Guyana,3,2,0,5
2012,Enero,1,1/1/2012,Guinea,1,0,0,1
2012,Enero,1,1/1/2012,Guinea Ecuatorial,0,1,0,1
2012,Enero,1,1/1/2012,Guayana Francesa/Departamento de Ultramar Francés,0,1,0,1
2012,Enero,1,1/1/2012,Haití,7,24,0,31
2012,Enero,1,1/1/2012,Honduras,127,219,0,346
2012,Enero,1,1/1/2012,Hungría,43,59,0,102
2012,Enero,1,1/1/2012,India,41,239,0,280
2012,Enero,1,1/1/2012,Indonesia,17,16,0,33
2012,Enero,1,1/1/2012,Irán,3,14,0,17
2012,Enero,1,1/1/2012,República de Irlanda,63,162,0,225
2012,Enero,1,1/1/2012,Islandia,9,6,0,15
2012,Enero,1,1/1/2012,Isla de Man,88,206,0,294
2012,Enero,1,1/1/2012,Isla Johnston,0,2,0,2
2012,Enero,1,1/1/2012,Israel,99,459,0,558
2012,Enero,1,1/1/2012,Islas Aland/Provincia de Finlandia,1,0,0,1
2012,Enero,1,1/1/2012,Isla Wake,0,1,0,1
2012,Enero,1,1/1/2012,Italia,726,2431,0,3157
2012,Enero,1,1/1/2012,Islas del Canal,0,1,0,1
2012,Enero,1,1/1/2012,Jamaica,22,24,0,46
2012,Enero,1,1/1/2012,Islas Marianas del Norte,0,1,0,1
2012,Enero,1,1/1/2012,Japón,150,493,0,643
2012,Enero,1,1/1/2012,Jordania,1,1,0,2
2012,Enero,1,1/1/2012,Kazajistán,1,1,0,2
2012,Enero,1,1/1/2012,Kenia,7,14,0,21
2012,Enero,1,1/1/2012,Kuwait,0,1,0,1
2012,Enero,1,1/1/2012,Letonia,13,10,0,23
2012,Enero,1,1/1/2012,Lituania,7,12,0,19
2012,Enero,1,1/1/2012,Líbano,14,39,0,53
2012,Enero,1,1/1/2012,Libia,0,1,0,1
2012,Enero,1,1/1/2012,Liechtenstein,1,4,0,5
2012,Enero,1,1/1/2012,Luxemburgo,1,9,0,10
2012,Enero,1,1/1/2012,Macedonia,0,1,0,1
2012,Enero,1,1/1/2012,Malasia,13,17,0,30
2012,Enero,1,1/1/2012,Malta,2,3,0,5
2012,Enero,1,1/1/2012,Marruecos,2,6,0,8
2012,Enero,1,1/1/2012,Mauricio,1,2,0,3
2012,Enero,1,1/1/2012,México,1959,4197,0,6156
2012,Enero,1,1/1/2012,República de Moldavia,3,0,0,3
2012,Enero,1,1/1/2012,Mónaco,1,1,0,2
2012,Enero,1,1/1/2012,Myanmar,1,0,0,1
2012,Enero,1,1/1/2012,Namibia,0,1,0,1
2012,Enero,1,1/1/2012,Nepal,0,4,0,4
2012,Enero,1,1/1/2012,Nicaragua,59,75,0,134
2012,Enero,1,1/1/2012,Nigeria,2,15,0,17
2012,Enero,1,1/1/2012,Noruega,89,182,0,271
2012,Enero,1,1/1/2012,Nueva Zelanda,47,86,0,133
2012,Enero,1,1/1/2012,Pakistán,1,19,0,20
2012,Enero,1,1/1/2012,Panamá,970,1430,0,2400
2012,Enero,1,1/1/2012,Paraguay,111,127,0,238
2012,Enero,1,1/1/2012,Perú,2627,3954,0,6581
2012,Enero,1,1/1/2012,Palestina,2,3,0,5
2012,Enero,1,1/1/2012,Polonia,110,167,0,277
2012,Enero,1,1/1/2012,Portugal,96,295,0,391
2012,Enero,1,1/1/2012,Puerto Rico/Territorio de Estados Unidos,0,1,0,1
2012,Enero,1,1/1/2012,Reino Unido de Gran Bretaña e Irlanda del Norte,603,1502,0,2105
2012,Enero,1,1/1/2012,República CentroÁfricana,0,1,0,1
2012,Enero,1,1/1/2012,Federación de Rusia,296,405,0,701
2012,Enero,1,1/1/2012,República Dominicana,237,430,0,667
2012,Enero,1,1/1/2012,República Democrática Popular de Corea,1,1,0,2
2012,Enero,1,1/1/2012,Rumania,31,65,0,96
2012,Enero,1,1/1/2012,Rwanda,1,1,0,2
2012,Enero,1,1/1/2012,San Marino,0,3,0,3
2012,Enero,1,1/1/2012,San  Vicente y las Granadinas,0,2,0,2
2012,Enero,1,1/1/2012,Santa Lucia,2,3,0,5
2012,Enero,1,1/1/2012,Santa Sede/Ciudad del Vaticano,0,2,0,2
2012,Enero,1,1/1/2012,Santo Tomé y Príncipe,0,1,0,1
2012,Enero,1,1/1/2012,Senegal,1,0,0,1
2012,Enero,1,1/1/2012,Serbia,2,7,0,9
2012,Enero,1,1/1/2012,Sierra Leona,0,1,0,1
2012,Enero,1,1/1/2012,Singapur,9,16,0,25
2012,Enero,1,1/1/2012,República Árabe Siria,1,5,0,6
2012,Enero,1,1/1/2012,Sri Lanka,0,2,0,2
2012,Enero,1,1/1/2012,Sudáfrica,30,84,0,114
2012,Enero,1,1/1/2012,Sudán,2,2,0,4
2012,Enero,1,1/1/2012,Suecia,245,389,0,634
2012,Enero,1,1/1/2012,Suiza,408,667,0,1075
2012,Enero,1,1/1/2012,Surinam,16,20,0,36
2012,Enero,1,1/1/2012,Taiwán,47,46,0,93
2012,Enero,1,1/1/2012,Tailandia,5,3,0,8
2012,Enero,1,1/1/2012,Territorio Antártico Británico/Territorio Británico de Ultramar,1,7,0,8
2012,Enero,1,1/1/2012,Tanzania,1,2,0,3
2012,Enero,1,1/1/2012,República Democrática de Timor Oriental,0,1,0,1
2012,Enero,1,1/1/2012,Togo,0,1,0,1
2012,Enero,1,1/1/2012,Trinidad y Tobago,23,60,0,83
2012,Enero,1,1/1/2012,Túnez,0,2,0,2
2012,Enero,1,1/1/2012,Turkmenistán,1,0,0,1
2012,Enero,1,1/1/2012,Turquía,26,115,0,141
2012,Enero,1,1/1/2012,Ucrania,31,30,0,61
2012,Enero,1,1/1/2012,Uganda,2,7,0,9
2012,Enero,1,1/1/2012,Uruguay,301,403,0,704
2012,Enero,1,1/1/2012,Uzbekistán,0,1,0,1
2012,Enero,1,1/1/2012,Venezuela,9716,11543,0,21259
2012,Enero,1,1/1/2012,Vietnam,1,1,0,2
2012,Enero,1,1/1/2012,Yugoslavia,1,3,0,4
2012,Enero,1,1/1/2012,Zimbabue,0,2,0,2
2012,Enero,1,1/1/2012,Desconocido,0,1,0,1
2012,Febrero,2,2/1/2012,Albania,0,1,0,1
2012,Febrero,2,2/1/2012,Alemania,1483,2473,0,3956
2012,Febrero,2,2/1/2012,Andorra,1,4,0,5
2012,Febrero,2,2/1/2012,Angola,4,0,0,4
2012,Febrero,2,2/1/2012,Antigua y Barbuda,1,2,0,3
2012,Febrero,2,2/1/2012,Países Bajos,818,1397,0,2215
2012,Febrero,2,2/1/2012,Arabia Saudita,0,3,0,3
2012,Febrero,2,2/1/2012,Argelia,0,2,0,2
2012,Febrero,2,2/1/2012,Argentina,4364,5728,0,10092
2012,Febrero,2,2/1/2012,República de Armenia,0,5,0,5
2012,Febrero,2,2/1/2012,Aruba,0,2,0,2
2012,Febrero,2,2/1/2012,Australia,291,553,0,844
2012,Febrero,2,2/1/2012,Austria,160,286,0,446
2012,Febrero,2,2/1/2012,Azerbaiyán,2,0,0,2
2012,Febrero,2,2/1/2012,Bahamas,6,17,0,23
2012,Febrero,2,2/1/2012,Bahréin,1,0,0,1
2012,Febrero,2,2/1/2012,Bangladesh,0,3,0,3
2012,Febrero,2,2/1/2012,Barbados,5,4,0,9
2012,Febrero,2,2/1/2012,República de Belarús,5,1,0,6
2012,Febrero,2,2/1/2012,Bélgica,143,371,0,514
2012,Febrero,2,2/1/2012,Belice,2,7,0,9
2012,Febrero,2,2/1/2012,Benín,2,2,0,4
2012,Febrero,2,2/1/2012,Bolivia,303,473,0,776
2012,Febrero,2,2/1/2012,Bosnia y Herzegovina,0,3,0,3
2012,Febrero,2,2/1/2012,Brasil,3326,4502,0,7828
2012,Febrero,2,2/1/2012,Bulgaria,7,8,0,15
2012,Febrero,2,2/1/2012,Burundi,0,1,0,1
2012,Febrero,2,2/1/2012,Islas Caimán/Territorio Británico de Ultramar,1,0,0,1
2012,Febrero,2,2/1/2012,Camboya,0,2,0,2
2012,Febrero,2,2/1/2012,Camerún,1,2,0,3
2012,Febrero,2,2/1/2012,Canadá,2489,3307,0,5796
2012,Febrero,2,2/1/2012,España,2088,5237,0,7325
2012,Febrero,2,2/1/2012,República Democrática del Congo,3,1,0,4
2012,Febrero,2,2/1/2012,República de Corea,115,447,0,562
2012,Febrero,2,2/1/2012,Costa de Marfil,1,0,0,1
2012,Febrero,2,2/1/2012,Costa Rica,703,981,0,1684
2012,Febrero,2,2/1/2012,Croacia,5,39,0,44
2012,Febrero,2,2/1/2012,Cuba,99,239,0,338
2012,Febrero,2,2/1/2012,Curazao,1,3,0,4
2012,Febrero,2,2/1/2012,República Checa,35,66,0,101
2012,Febrero,2,2/1/2012,Chile,3625,4281,0,7906
2012,Febrero,2,2/1/2012,China,151,470,0,621
2012,Febrero,2,2/1/2012,Chipre,0,1,0,1
2012,Febrero,2,2/1/2012,Dinamarca,58,156,0,214
2012,Febrero,2,2/1/2012,República de Yibuti,0,1,0,1
2012,Febrero,2,2/1/2012,Dominica,5,5,0,10
2012,Febrero,2,2/1/2012,Ecuador,4036,5379,0,9415
2012,Febrero,2,2/1/2012,Egipto,5,19,0,24
2012,Febrero,2,2/1/2012,El Salvador,437,647,0,1084
2012,Febrero,2,2/1/2012,Emiratos Árabes,1,3,0,4
2012,Febrero,2,2/1/2012,Eslovaquia,20,18,0,38
2012,Febrero,2,2/1/2012,Eslovenia,19,29,0,48
2012,Febrero,2,2/1/2012,Estados Unidos de América,8240,17133,0,25373
2012,Febrero,2,2/1/2012,Estonia,24,20,0,44
2012,Febrero,2,2/1/2012,Etiopia,0,3,0,3
2012,Febrero,2,2/1/2012,Filipinas,21,216,0,237
2012,Febrero,2,2/1/2012,Finlandia,229,252,0,481
2012,Febrero,2,2/1/2012,Francia,1256,2108,0,3364
2012,Febrero,2,2/1/2012,Gabón,0,1,0,1
2012,Febrero,2,2/1/2012,Gambia,0,1,0,1
2012,Febrero,2,2/1/2012,Ghana,2,6,0,8
2012,Febrero,2,2/1/2012,Granada,1,2,0,3
2012,Febrero,2,2/1/2012,Grecia,33,80,0,113
2012,Febrero,2,2/1/2012,Guatemala,177,523,0,700
2012,Febrero,2,2/1/2012,Guyana,2,12,0,14
2012,Febrero,2,2/1/2012,Haití,1,16,0,17
2012,Febrero,2,2/1/2012,Honduras,147,238,0,385
2012,Febrero,2,2/1/2012,Hungría,42,45,0,87
2012,Febrero,2,2/1/2012,India,26,342,0,368
2012,Febrero,2,2/1/2012,Indonesia,9,22,0,31
2012,Febrero,2,2/1/2012,Irán,4,16,0,20
2012,Febrero,2,2/1/2012,República de Irlanda,56,112,0,168
2012,Febrero,2,2/1/2012,Islandia,9,13,0,22
2012,Febrero,2,2/1/2012,Isla de Man,65,218,0,283
2012,Febrero,2,2/1/2012,Isla Johnston,2,1,0,3
2012,Febrero,2,2/1/2012,Israel,128,573,0,701
2012,Febrero,2,2/1/2012,Islas Aland/Provincia de Finlandia,0,1,0,1
2012,Febrero,2,2/1/2012,Isla Wake,1,0,0,1
2012,Febrero,2,2/1/2012,Italia,621,2029,0,2650
2012,Febrero,2,2/1/2012,Jamaica,14,26,0,40
2012,Febrero,2,2/1/2012,Islas Salomón,1,0,0,1
2012,Febrero,2,2/1/2012,Papúa Occidental,1,0,0,1
2012,Febrero,2,2/1/2012,Japón,186,500,0,686
2012,Febrero,2,2/1/2012,Jordania,2,4,0,6
2012,Febrero,2,2/1/2012,Kazajistán,4,1,0,5
2012,Febrero,2,2/1/2012,Kenia,0,16,0,16
2012,Febrero,2,2/1/2012,Kirguistán,0,1,0,1
2012,Febrero,2,2/1/2012,Kuwait,1,0,0,1
2012,Febrero,2,2/1/2012,República de Kosovo,1,0,0,1
2012,Febrero,2,2/1/2012,Lesoto,0,1,0,1
2012,Febrero,2,2/1/2012,Letonia,6,4,0,10
2012,Febrero,2,2/1/2012,Lituania,16,15,0,31
2012,Febrero,2,2/1/2012,Líbano,20,38,0,58
2012,Febrero,2,2/1/2012,Liechtenstein,1,4,0,5
2012,Febrero,2,2/1/2012,Luxemburgo,4,13,0,17
2012,Febrero,2,2/1/2012,Macedonia,1,0,0,1
2012,Febrero,2,2/1/2012,Madagascar,1,0,0,1
2012,Febrero,2,2/1/2012,Malasia,9,26,0,35
2012,Febrero,2,2/1/2012,Malta,1,2,0,3
2012,Febrero,2,2/1/2012,Marruecos,1,9,0,10
2012,Febrero,2,2/1/2012,Mauricio,1,0,0,1
2012,Febrero,2,2/1/2012,México,1692,4388,0,6080
2012,Febrero,2,2/1/2012,República de Moldavia,2,0,0,2
2012,Febrero,2,2/1/2012,Mongolia,1,0,0,1
2012,Febrero,2,2/1/2012,Mozambique,0,1,0,1
2012,Febrero,2,2/1/2012,Myanmar,1,1,0,2
2012,Febrero,2,2/1/2012,Nicaragua,72,69,0,141
2012,Febrero,2,2/1/2012,Nigeria,3,6,0,9
2012,Febrero,2,2/1/2012,Noruega,120,201,0,321
2012,Febrero,2,2/1/2012,Nueva Zelanda,36,101,0,137
2012,Febrero,2,2/1/2012,Papúa Nueva Guinea,0,1,0,1
2012,Febrero,2,2/1/2012,Pakistán,0,9,0,9
2012,Febrero,2,2/1/2012,Panamá,1045,1533,0,2578
2012,Febrero,2,2/1/2012,Paraguay,101,128,0,229
2012,Febrero,2,2/1/2012,Perú,3715,4638,0,8353
2012,Febrero,2,2/1/2012,Palestina,0,3,0,3
2012,Febrero,2,2/1/2012,Polonia,111,235,0,346
2012,Febrero,2,2/1/2012,Portugal,86,271,0,357
2012,Febrero,2,2/1/2012,Puerto Rico/Territorio de Estados Unidos,0,3,0,3
2012,Febrero,2,2/1/2012,Reino Unido de Gran Bretaña e Irlanda del Norte,531,1286,0,1817
2012,Febrero,2,2/1/2012,República CentroÁfricana,1,1,0,2
2012,Febrero,2,2/1/2012,Federación de Rusia,200,249,0,449
2012,Febrero,2,2/1/2012,República Dominicana,268,499,0,767
2012,Febrero,2,2/1/2012,Rumania,40,59,0,99
2012,Febrero,2,2/1/2012,Rwanda,0,1,0,1
2012,Febrero,2,2/1/2012,San Cristóbal y Nevis,1,2,0,3
2012,Febrero,2,2/1/2012,Samoa Occidental,1,0,0,1
2012,Febrero,2,2/1/2012,San Marino,0,2,0,2
2012,Febrero,2,2/1/2012,San  Vicente y las Granadinas,2,1,0,3
2012,Febrero,2,2/1/2012,Santa Lucia,2,3,0,5
2012,Febrero,2,2/1/2012,Senegal,1,0,0,1
2012,Febrero,2,2/1/2012,Serbia,8,9,0,17
2012,Febrero,2,2/1/2012,Singapur,1,15,0,16
2012,Febrero,2,2/1/2012,República Árabe Siria,0,1,0,1
2012,Febrero,2,2/1/2012,Sri Lanka,0,3,0,3
2012,Febrero,2,2/1/2012,Sudáfrica,16,82,0,98
2012,Febrero,2,2/1/2012,Sudán,0,2,0,2
2012,Febrero,2,2/1/2012,Suecia,238,308,0,546
2012,Febrero,2,2/1/2012,Suiza,392,663,0,1055
2012,Febrero,2,2/1/2012,Surinam,13,14,0,27
2012,Febrero,2,2/1/2012,Taiwán,46,76,0,122
2012,Febrero,2,2/1/2012,Tailandia,4,2,0,6
2012,Febrero,2,2/1/2012,Tíbet/Región Autónoma de China,0,1,0,1
2012,Febrero,2,2/1/2012,Territorio Antártico Británico/Territorio Británico de Ultramar,1,6,0,7
2012,Febrero,2,2/1/2012,Tanzania,2,5,0,7
2012,Febrero,2,2/1/2012,Trinidad y Tobago,20,51,0,71
2012,Febrero,2,2/1/2012,Túnez,0,1,0,1
2012,Febrero,2,2/1/2012,Turquía,25,84,0,109
2012,Febrero,2,2/1/2012,Ucrania,21,30,0,51
2012,Febrero,2,2/1/2012,Uganda,0,4,0,4
2012,Febrero,2,2/1/2012,Uruguay,358,485,0,843
2012,Febrero,2,2/1/2012,Venezuela,8489,10738,0,19227
2012,Febrero,2,2/1/2012,Vietnam,4,1,0,5
2012,Febrero,2,2/1/2012,Yugoslavia,0,1,0,1
2012,Febrero,2,2/1/2012,Zambia,1,3,0,4
2012,Febrero,2,2/1/2012,Zimbabue,1,1,0,2
2012,Febrero,2,2/1/2012,Desconocido,0,1,0,1
2012,Marzo,3,3/1/2012,Albania,1,0,0,1
2012,Marzo,3,3/1/2012,Alemania,1604,2586,0,4190
2012,Marzo,3,3/1/2012,Andorra,1,10,0,11
2012,Marzo,3,3/1/2012,Angola,1,2,0,3
2012,Marzo,3,3/1/2012,Antigua y Barbuda,2,1,0,3
2012,Marzo,3,3/1/2012,Países Bajos,816,1438,0,2254
2012,Marzo,3,3/1/2012,Arabia Saudita,1,3,0,4
2012,Marzo,3,3/1/2012,Argelia,0,1,0,1
2012,Marzo,3,3/1/2012,Argentina,4472,5863,0,10335
2012,Marzo,3,3/1/2012,República de Armenia,0,2,0,2
2012,Marzo,3,3/1/2012,Aruba,4,4,0,8
2012,Marzo,3,3/1/2012,Australia,286,538,0,824
2012,Marzo,3,3/1/2012,Austria,117,226,0,343
2012,Marzo,3,3/1/2012,Azerbaiyán,1,2,0,3
2012,Marzo,3,3/1/2012,Bahamas,2,16,0,18
2012,Marzo,3,3/1/2012,Bahréin,0,1,0,1
2012,Marzo,3,3/1/2012,Bangladesh,2,1,0,3
2012,Marzo,3,3/1/2012,Barbados,4,7,0,11
2012,Marzo,3,3/1/2012,República de Belarús,4,0,0,4
2012,Marzo,3,3/1/2012,Bélgica,138,354,0,492
2012,Marzo,3,3/1/2012,Belice,3,9,0,12
2012,Marzo,3,3/1/2012,Benín,0,1,0,1
2012,Marzo,3,3/1/2012,Bermudas/Territorio Británico de Ultramar,0,6,0,6
2012,Marzo,3,3/1/2012,Bolivia,382,488,0,870
2012,Marzo,3,3/1/2012,Bosnia y Herzegovina,0,2,0,2
2012,Marzo,3,3/1/2012,Brasil,2229,4058,0,6287
2012,Marzo,3,3/1/2012,Bulgaria,2,11,0,13
2012,Marzo,3,3/1/2012,Islas Caimán/Territorio Británico de Ultramar,1,2,0,3
2012,Marzo,3,3/1/2012,Camboya,1,2,0,3
2012,Marzo,3,3/1/2012,Camerún,0,4,0,4
2012,Marzo,3,3/1/2012,Canadá,2597,3274,0,5871
2012,Marzo,3,3/1/2012,España,2268,5384,0,7652
2012,Marzo,3,3/1/2012,República Democrática del Congo,3,6,0,9
2012,Marzo,3,3/1/2012,República de Corea,117,497,0,614
2012,Marzo,3,3/1/2012,Costa de Marfil,0,2,0,2
2012,Marzo,3,3/1/2012,Costa Rica,812,1089,0,1901
2012,Marzo,3,3/1/2012,Croacia,8,62,0,70
2012,Marzo,3,3/1/2012,Cuba,103,218,0,321
2012,Marzo,3,3/1/2012,Curazao,5,4,0,9
2012,Marzo,3,3/1/2012,República Checa,47,73,0,120
2012,Marzo,3,3/1/2012,Chile,2459,3687,0,6146
2012,Marzo,3,3/1/2012,China,168,484,0,652
2012,Marzo,3,3/1/2012,Chipre,0,5,0,5
2012,Marzo,3,3/1/2012,Dinamarca,76,188,0,264
2012,Marzo,3,3/1/2012,Dominica,1,10,0,11
2012,Marzo,3,3/1/2012,Ecuador,3625,5558,0,9183
2012,Marzo,3,3/1/2012,Egipto,4,13,0,17
2012,Marzo,3,3/1/2012,El Salvador,424,578,0,1002
2012,Marzo,3,3/1/2012,Emiratos Árabes,1,24,0,25
2012,Marzo,3,3/1/2012,Eslovaquia,25,16,0,41
2012,Marzo,3,3/1/2012,Eslovenia,17,36,0,53
2012,Marzo,3,3/1/2012,Estados Unidos de América,9331,18243,0,27574
2012,Marzo,3,3/1/2012,Estonia,24,21,0,45
2012,Marzo,3,3/1/2012,Etiopia,2,7,0,9
2012,Marzo,3,3/1/2012,Filipinas,21,184,0,205
2012,Marzo,3,3/1/2012,Finlandia,149,161,0,310
2012,Marzo,3,3/1/2012,Francia,972,2016,0,2988
2012,Marzo,3,3/1/2012,Georgia,9,16,0,25
2012,Marzo,3,3/1/2012,Ghana,2,3,0,5
2012,Marzo,3,3/1/2012,Grecia,23,71,0,94
2012,Marzo,3,3/1/2012,Guatemala,270,591,0,861
2012,Marzo,3,3/1/2012,Guyana,3,27,0,30
2012,Marzo,3,3/1/2012,Guinea Ecuatorial,1,0,0,1
2012,Marzo,3,3/1/2012,Guinea Bissau,0,1,0,1
2012,Marzo,3,3/1/2012,Haití,8,31,0,39
2012,Marzo,3,3/1/2012,Honduras,190,266,0,456
2012,Marzo,3,3/1/2012,Hungría,28,39,0,67
2012,Marzo,3,3/1/2012,India,55,275,0,330
2012,Marzo,3,3/1/2012,Indonesia,9,44,0,53
2012,Marzo,3,3/1/2012,Iraq,0,2,0,2
2012,Marzo,3,3/1/2012,Irán,6,16,0,22
2012,Marzo,3,3/1/2012,República de Irlanda,57,144,0,201
2012,Marzo,3,3/1/2012,Islandia,7,4,0,11
2012,Marzo,3,3/1/2012,Isla de Man,110,284,0,394
2012,Marzo,3,3/1/2012,Isla Johnston,0,1,0,1
2012,Marzo,3,3/1/2012,Israel,101,548,0,649
2012,Marzo,3,3/1/2012,Islas Aland/Provincia de Finlandia,0,1,0,1
2012,Marzo,3,3/1/2012,Italia,530,2116,0,2646
2012,Marzo,3,3/1/2012,Islas del Canal,1,1,0,2
2012,Marzo,3,3/1/2012,Jamaica,10,29,0,39
2012,Marzo,3,3/1/2012,Japón,255,571,0,826
2012,Marzo,3,3/1/2012,Jordania,3,9,0,12
2012,Marzo,3,3/1/2012,Kazajistán,2,3,0,5
2012,Marzo,3,3/1/2012,Kenia,4,9,0,13
2012,Marzo,3,3/1/2012,Kirguistán,0,1,0,1
2012,Marzo,3,3/1/2012,Kuwait,0,3,0,3
2012,Marzo,3,3/1/2012,República de Kosovo,6,14,0,20
2012,Marzo,3,3/1/2012,Letonia,8,17,0,25
2012,Marzo,3,3/1/2012,Lituania,10,14,0,24
2012,Marzo,3,3/1/2012,Líbano,16,45,0,61
2012,Marzo,3,3/1/2012,Liberia,0,1,0,1
2012,Marzo,3,3/1/2012,Liechtenstein,4,3,0,7
2012,Marzo,3,3/1/2012,Luxemburgo,8,20,0,28
2012,Marzo,3,3/1/2012,Macedonia,1,4,0,5
2012,Marzo,3,3/1/2012,Madagascar,0,2,0,2
2012,Marzo,3,3/1/2012,Malasia,7,22,0,29
2012,Marzo,3,3/1/2012,Malawi,2,0,0,2
2012,Marzo,3,3/1/2012,Malta,1,6,0,7
2012,Marzo,3,3/1/2012,Marruecos,6,10,0,16
2012,Marzo,3,3/1/2012,Mauricio,0,1,0,1
2012,Marzo,3,3/1/2012,México,1942,4690,0,6632
2012,Marzo,3,3/1/2012,República de Moldavia,2,0,0,2
2012,Marzo,3,3/1/2012,Mónaco,0,1,0,1
2012,Marzo,3,3/1/2012,Mozambique,1,1,0,2
2012,Marzo,3,3/1/2012,Myanmar,1,0,0,1
2012,Marzo,3,3/1/2012,Namibia,0,1,0,1
2012,Marzo,3,3/1/2012,Nepal,0,4,0,4
2012,Marzo,3,3/1/2012,Nicaragua,61,96,0,157
2012,Marzo,3,3/1/2012,Nigeria,2,5,0,7
2012,Marzo,3,3/1/2012,Noruega,94,176,0,270
2012,Marzo,3,3/1/2012,Nueva Caledonia/Territorio francés,0,1,0,1
2012,Marzo,3,3/1/2012,Nueva Zelanda,49,97,0,146
2012,Marzo,3,3/1/2012,Omán,0,2,0,2
2012,Marzo,3,3/1/2012,Pakistán,2,26,0,28
2012,Marzo,3,3/1/2012,Panamá,821,1564,0,2385
2012,Marzo,3,3/1/2012,Paraguay,59,104,0,163
2012,Marzo,3,3/1/2012,Perú,3228,4747,0,7975
2012,Marzo,3,3/1/2012,Palestina,0,3,0,3
2012,Marzo,3,3/1/2012,Polonia,100,189,0,289
2012,Marzo,3,3/1/2012,Portugal,92,278,0,370
2012,Marzo,3,3/1/2012,Puerto Rico/Territorio de Estados Unidos,2,4,0,6
2012,Marzo,3,3/1/2012,Reino Unido de Gran Bretaña e Irlanda del Norte,628,1467,0,2095
2012,Marzo,3,3/1/2012,República CentroÁfricana,0,4,0,4
2012,Marzo,3,3/1/2012,Federación de Rusia,176,249,0,425
2012,Marzo,3,3/1/2012,República Dominicana,320,462,0,782
2012,Marzo,3,3/1/2012,Rumania,46,95,0,141
2012,Marzo,3,3/1/2012,San Cristóbal y Nevis,0,2,0,2
2012,Marzo,3,3/1/2012,San Marino,0,1,0,1
2012,Marzo,3,3/1/2012,San  Vicente y las Granadinas,1,2,0,3
2012,Marzo,3,3/1/2012,Santa Lucia,5,11,0,16
2012,Marzo,3,3/1/2012,Santa Sede/Ciudad del Vaticano,0,1,0,1
2012,Marzo,3,3/1/2012,Senegal,1,2,0,3
2012,Marzo,3,3/1/2012,Serbia,16,20,0,36
2012,Marzo,3,3/1/2012,Sierra Leona,0,1,0,1
2012,Marzo,3,3/1/2012,Singapur,13,17,0,30
2012,Marzo,3,3/1/2012,República Árabe Siria,1,4,0,5
2012,Marzo,3,3/1/2012,Sri Lanka,0,1,0,1
2012,Marzo,3,3/1/2012,Sudáfrica,39,91,0,130
2012,Marzo,3,3/1/2012,Sudán,0,1,0,1
2012,Marzo,3,3/1/2012,Suecia,177,327,0,504
2012,Marzo,3,3/1/2012,Suiza,329,646,0,975
2012,Marzo,3,3/1/2012,Surinam,6,19,0,25
2012,Marzo,3,3/1/2012,Suazilandia,1,0,0,1
2012,Marzo,3,3/1/2012,Taiwán,23,61,0,84
2012,Marzo,3,3/1/2012,República de Tayikistán,1,0,0,1
2012,Marzo,3,3/1/2012,Tailandia,5,2,0,7
2012,Marzo,3,3/1/2012,Territorio Antártico Británico/Territorio Británico de Ultramar,1,4,0,5
2012,Marzo,3,3/1/2012,Tanzania,2,1,0,3
2012,Marzo,3,3/1/2012,Togo,0,1,0,1
2012,Marzo,3,3/1/2012,Trinidad y Tobago,27,106,0,133
2012,Marzo,3,3/1/2012,Túnez,1,6,0,7
2012,Marzo,3,3/1/2012,Turquía,22,95,0,117
2012,Marzo,3,3/1/2012,Ucrania,29,30,0,59
2012,Marzo,3,3/1/2012,Uganda,1,4,0,5
2012,Marzo,3,3/1/2012,Uruguay,335,492,0,827
2012,Marzo,3,3/1/2012,Uzbekistán,2,0,0,2
2012,Marzo,3,3/1/2012,Venezuela,7666,10026,0,17692
2012,Marzo,3,3/1/2012,Vietnam,2,2,0,4
2012,Marzo,3,3/1/2012,Yugoslavia,1,0,0,1
2012,Marzo,3,3/1/2012,Zambia,0,1,0,1
2012,Marzo,3,3/1/2012,Zimbabue,1,3,0,4
2012,Abril,4,4/1/2012,Albania,3,4,0,7
2012,Abril,4,4/1/2012,Alemania,943,1748,0,2691
2012,Abril,4,4/1/2012,Andorra,1,7,0,8
2012,Abril,4,4/1/2012,Angola,0,2,0,2
2012,Abril,4,4/1/2012,Antigua y Barbuda,2,2,0,4
2012,Abril,4,4/1/2012,Países Bajos,855,1436,0,2291
2012,Abril,4,4/1/2012,Arabia Saudita,0,5,0,5
2012,Abril,4,4/1/2012,Argelia,1,3,0,4
2012,Abril,4,4/1/2012,Argentina,4095,5380,0,9475
2012,Abril,4,4/1/2012,República de Armenia,1,1,0,2
2012,Abril,4,4/1/2012,Aruba,1,2,0,3
2012,Abril,4,4/1/2012,Australia,280,501,0,781
2012,Abril,4,4/1/2012,Austria,89,194,0,283
2012,Abril,4,4/1/2012,Azerbaiyán,1,2,0,3
2012,Abril,4,4/1/2012,Bahamas,3,15,0,18
2012,Abril,4,4/1/2012,Bangladesh,0,3,0,3
2012,Abril,4,4/1/2012,Barbados,12,12,0,24
2012,Abril,4,4/1/2012,República de Belarús,1,3,0,4
2012,Abril,4,4/1/2012,Bélgica,101,292,0,393
2012,Abril,4,4/1/2012,Belice,5,13,0,18
2012,Abril,4,4/1/2012,Bolivia,325,469,0,794
2012,Abril,4,4/1/2012,Bosnia y Herzegovina,0,2,0,2
2012,Abril,4,4/1/2012,Brasil,2837,4315,0,7152
2012,Abril,4,4/1/2012,Bulgaria,8,9,0,17
2012,Abril,4,4/1/2012,Burkina Faso,0,1,0,1
2012,Abril,4,4/1/2012,Islas Caimán/Territorio Británico de Ultramar,0,2,0,2
2012,Abril,4,4/1/2012,Camerún,0,2,0,2
2012,Abril,4,4/1/2012,Canadá,1032,1878,0,2910
2012,Abril,4,4/1/2012,España,2055,4803,0,6858
2012,Abril,4,4/1/2012,República Democrática del Congo,1,1,0,2
2012,Abril,4,4/1/2012,República de Corea,186,444,0,630
2012,Abril,4,4/1/2012,Costa de Marfil,0,2,0,2
2012,Abril,4,4/1/2012,Costa Rica,858,1106,0,1964
2012,Abril,4,4/1/2012,Croacia,6,45,0,51
2012,Abril,4,4/1/2012,Cuba,122,259,0,381
2012,Abril,4,4/1/2012,Curazao,1,6,0,7
2012,Abril,4,4/1/2012,República Checa,31,31,0,62
2012,Abril,4,4/1/2012,Chile,2254,3484,0,5738
2012,Abril,4,4/1/2012,China,169,550,0,719
2012,Abril,4,4/1/2012,Chipre,3,3,0,6
2012,Abril,4,4/1/2012,Dinamarca,61,151,0,212
2012,Abril,4,4/1/2012,Dominica,4,12,0,16
2012,Abril,4,4/1/2012,Ecuador,3324,4804,0,8128
2012,Abril,4,4/1/2012,Egipto,4,17,0,21
2012,Abril,4,4/1/2012,El Salvador,404,627,0,1031
2012,Abril,4,4/1/2012,Emiratos Árabes,0,7,0,7
2012,Abril,4,4/1/2012,Eslovaquia,19,32,0,51
2012,Abril,4,4/1/2012,Eslovenia,9,39,0,48
2012,Abril,4,4/1/2012,Estados Unidos de América,7245,15879,0,23124
2012,Abril,4,4/1/2012,Estonia,5,5,0,10
2012,Abril,4,4/1/2012,Etiopia,0,3,0,3
2012,Abril,4,4/1/2012,Filipinas,16,127,0,143
2012,Abril,4,4/1/2012,Finlandia,41,78,0,119
2012,Abril,4,4/1/2012,Francia,1027,1917,0,2944
2012,Abril,4,4/1/2012,Georgia,0,1,0,1
2012,Abril,4,4/1/2012,Granada,3,8,0,11
2012,Abril,4,4/1/2012,Grecia,8,51,0,59
2012,Abril,4,4/1/2012,Guatemala,232,520,0,752
2012,Abril,4,4/1/2012,Guyana,6,15,0,21
2012,Abril,4,4/1/2012,Guinea,1,1,0,2
2012,Abril,4,4/1/2012,Guayana Francesa/Departamento de Ultramar Francés,0,1,0,1
2012,Abril,4,4/1/2012,Haití,8,27,0,35
2012,Abril,4,4/1/2012,Honduras,163,262,0,425
2012,Abril,4,4/1/2012,Hungría,11,26,0,37
2012,Abril,4,4/1/2012,India,37,241,0,278
2012,Abril,4,4/1/2012,Indonesia,7,87,0,94
2012,Abril,4,4/1/2012,Irán,2,14,0,16
2012,Abril,4,4/1/2012,República de Irlanda,51,118,0,169
2012,Abril,4,4/1/2012,Islandia,4,3,0,7
2012,Abril,4,4/1/2012,Isla de Man,91,240,0,331
2012,Abril,4,4/1/2012,Isla Johnston,0,2,0,2
2012,Abril,4,4/1/2012,Israel,123,644,0,767
2012,Abril,4,4/1/2012,Islas Aland/Provincia de Finlandia,0,1,0,1
2012,Abril,4,4/1/2012,Italia,415,1595,0,2010
2012,Abril,4,4/1/2012,Jamaica,21,37,0,58
2012,Abril,4,4/1/2012,Japón,142,449,0,591
2012,Abril,4,4/1/2012,Jordania,2,1,0,3
2012,Abril,4,4/1/2012,Kazajistán,2,3,0,5
2012,Abril,4,4/1/2012,Kenia,0,8,0,8
2012,Abril,4,4/1/2012,Kirguistán,0,1,0,1
2012,Abril,4,4/1/2012,Kuwait,0,1,0,1
2012,Abril,4,4/1/2012,República de Kosovo,1,0,0,1
2012,Abril,4,4/1/2012,Letonia,4,6,0,10
2012,Abril,4,4/1/2012,Lituania,11,16,0,27
2012,Abril,4,4/1/2012,Líbano,19,34,0,53
2012,Abril,4,4/1/2012,Liechtenstein,2,3,0,5
2012,Abril,4,4/1/2012,Luxemburgo,4,9,0,13
2012,Abril,4,4/1/2012,Macedonia,1,1,0,2
2012,Abril,4,4/1/2012,Madagascar,1,0,0,1
2012,Abril,4,4/1/2012,Malasia,7,22,0,29
2012,Abril,4,4/1/2012,Malawi,0,1,0,1
2012,Abril,4,4/1/2012,Malta,0,5,0,5
2012,Abril,4,4/1/2012,Marruecos,4,6,0,10
2012,Abril,4,4/1/2012,Mauricio,0,1,0,1
2012,Abril,4,4/1/2012,México,2061,4698,0,6759
2012,Abril,4,4/1/2012,Mónaco,1,1,0,2
2012,Abril,4,4/1/2012,Montenegro,0,1,0,1
2012,Abril,4,4/1/2012,Mozambique,1,1,0,2
2012,Abril,4,4/1/2012,Namibia,1,1,0,2
2012,Abril,4,4/1/2012,Nepal,1,3,0,4
2012,Abril,4,4/1/2012,Nicaragua,56,96,0,152
2012,Abril,4,4/1/2012,Nigeria,0,7,0,7
2012,Abril,4,4/1/2012,Níger,0,1,0,1
2012,Abril,4,4/1/2012,Noruega,61,128,0,189
2012,Abril,4,4/1/2012,Nueva Zelanda,53,88,0,141
2012,Abril,4,4/1/2012,Pakistán,6,17,0,23
2012,Abril,4,4/1/2012,Panamá,807,1444,0,2251
2012,Abril,4,4/1/2012,Paraguay,98,100,0,198
2012,Abril,4,4/1/2012,Perú,2873,3956,0,6829
2012,Abril,4,4/1/2012,Palestina,1,2,0,3
2012,Abril,4,4/1/2012,Polonia,74,161,0,235
2012,Abril,4,4/1/2012,Portugal,81,272,0,353
2012,Abril,4,4/1/2012,Puerto Rico/Territorio de Estados Unidos,0,5,0,5
2012,Abril,4,4/1/2012,Reino Unido de Gran Bretaña e Irlanda del Norte,482,1302,0,1784
2012,Abril,4,4/1/2012,Federación de Rusia,162,255,0,417
2012,Abril,4,4/1/2012,República Dominicana,301,435,0,736
2012,Abril,4,4/1/2012,Rumania,46,79,0,125
2012,Abril,4,4/1/2012,San Cristóbal y Nevis,2,3,0,5
2012,Abril,4,4/1/2012,San Marino,1,3,0,4
2012,Abril,4,4/1/2012,San  Vicente y las Granadinas,2,4,0,6
2012,Abril,4,4/1/2012,Santa Lucia,4,7,0,11
2012,Abril,4,4/1/2012,Santa Sede/Ciudad del Vaticano,1,0,0,1
2012,Abril,4,4/1/2012,Senegal,0,1,0,1
2012,Abril,4,4/1/2012,Serbia,1,5,0,6
2012,Abril,4,4/1/2012,Singapur,7,17,0,24
2012,Abril,4,4/1/2012,República Árabe Siria,0,3,0,3
2012,Abril,4,4/1/2012,Sri Lanka,0,2,0,2
2012,Abril,4,4/1/2012,Sudáfrica,20,74,0,94
2012,Abril,4,4/1/2012,Sudán,2,6,0,8
2012,Abril,4,4/1/2012,Suecia,172,257,0,429
2012,Abril,4,4/1/2012,Suiza,305,569,0,874
2012,Abril,4,4/1/2012,Surinam,34,39,0,73
2012,Abril,4,4/1/2012,Taiwán,52,98,0,150
2012,Abril,4,4/1/2012,Tailandia,3,6,0,9
2012,Abril,4,4/1/2012,Territorio Antártico Británico/Territorio Británico de Ultramar,0,4,0,4
2012,Abril,4,4/1/2012,Tanzania,0,1,0,1
2012,Abril,4,4/1/2012,Trinidad y Tobago,26,122,0,148
2012,Abril,4,4/1/2012,Túnez,0,5,0,5
2012,Abril,4,4/1/2012,Turquía,13,46,0,59
2012,Abril,4,4/1/2012,Ucrania,25,26,0,51
2012,Abril,4,4/1/2012,Uganda,1,2,0,3
2012,Abril,4,4/1/2012,Uruguay,337,536,0,873
2012,Abril,4,4/1/2012,Venezuela,9215,10724,0,19939
2012,Abril,4,4/1/2012,Vietnam,0,17,0,17
2012,Abril,4,4/1/2012,República Árabe de Yemen,0,1,0,1
2012,Abril,4,4/1/2012,Yugoslavia,1,0,0,1
2012,Mayo,5,5/1/2012,Afganistán,0,1,0,1
2012,Mayo,5,5/1/2012,Albania,1,1,0,2
2012,Mayo,5,5/1/2012,Alemania,954,1744,0,2698
2012,Mayo,5,5/1/2012,Andorra,1,9,0,10
2012,Mayo,5,5/1/2012,Angola,0,3,0,3
2012,Mayo,5,5/1/2012,Países Bajos,724,1261,0,1985
2012,Mayo,5,5/1/2012,Arabia Saudita,0,3,0,3
2012,Mayo,5,5/1/2012,Argelia,1,4,0,5
2012,Mayo,5,5/1/2012,Argentina,3507,4942,0,8449
2012,Mayo,5,5/1/2012,Aruba,1,4,0,5
2012,Mayo,5,5/1/2012,Australia,275,547,0,822
2012,Mayo,5,5/1/2012,Austria,80,181,0,261
2012,Mayo,5,5/1/2012,Bahamas,3,16,0,19
2012,Mayo,5,5/1/2012,Bangladesh,1,0,0,1
2012,Mayo,5,5/1/2012,Barbados,2,6,0,8
2012,Mayo,5,5/1/2012,República de Belarús,0,3,0,3
2012,Mayo,5,5/1/2012,Bélgica,79,264,0,343
2012,Mayo,5,5/1/2012,Belice,2,5,0,7
2012,Mayo,5,5/1/2012,Benín,2,0,0,2
2012,Mayo,5,5/1/2012,Bermudas/Territorio Británico de Ultramar,0,1,0,1
2012,Mayo,5,5/1/2012,Bolivia,307,450,0,757
2012,Mayo,5,5/1/2012,Bosnia y Herzegovina,1,1,0,2
2012,Mayo,5,5/1/2012,Botsuana,0,1,0,1
2012,Mayo,5,5/1/2012,Brasil,2601,4325,0,6926
2012,Mayo,5,5/1/2012,Bulgaria,8,10,0,18
2012,Mayo,5,5/1/2012,Burkina Faso,0,1,0,1
2012,Mayo,5,5/1/2012,Cabo Verde,0,1,0,1
2012,Mayo,5,5/1/2012,Islas Caimán/Territorio Británico de Ultramar,3,1,0,4
2012,Mayo,5,5/1/2012,Camboya,0,1,0,1
2012,Mayo,5,5/1/2012,Camerún,0,2,0,2
2012,Mayo,5,5/1/2012,Canadá,693,1581,0,2274
2012,Mayo,5,5/1/2012,España,1859,5034,0,6893
2012,Mayo,5,5/1/2012,República Democrática del Congo,1,1,0,2
2012,Mayo,5,5/1/2012,República de Corea,160,415,0,575
2012,Mayo,5,5/1/2012,Costa de Marfil,0,3,0,3
2012,Mayo,5,5/1/2012,Costa Rica,641,924,0,1565
2012,Mayo,5,5/1/2012,Croacia,5,35,0,40
2012,Mayo,5,5/1/2012,Cuba,91,240,0,331
2012,Mayo,5,5/1/2012,Curazao,3,4,0,7
2012,Mayo,5,5/1/2012,República Checa,26,52,0,78
2012,Mayo,5,5/1/2012,Chile,2509,3718,0,6227
2012,Mayo,5,5/1/2012,China,182,590,0,772
2012,Mayo,5,5/1/2012,Chipre,3,3,0,6
2012,Mayo,5,5/1/2012,Dinamarca,58,103,0,161
2012,Mayo,5,5/1/2012,Dominica,3,5,0,8
2012,Mayo,5,5/1/2012,Ecuador,3030,5099,0,8129
2012,Mayo,5,5/1/2012,Egipto,6,19,0,25
2012,Mayo,5,5/1/2012,El Salvador,346,607,0,953
2012,Mayo,5,5/1/2012,Emiratos Árabes,2,9,0,11
2012,Mayo,5,5/1/2012,Eslovaquia,15,11,0,26
2012,Mayo,5,5/1/2012,Eslovenia,6,25,0,31
2012,Mayo,5,5/1/2012,Estados Unidos de América,8768,17372,0,26140
2012,Mayo,5,5/1/2012,Estonia,4,8,0,12
2012,Mayo,5,5/1/2012,Etiopia,2,0,0,2
2012,Mayo,5,5/1/2012,Islas Fiji,1,0,0,1
2012,Mayo,5,5/1/2012,Filipinas,22,141,0,163
2012,Mayo,5,5/1/2012,Finlandia,50,70,0,120
2012,Mayo,5,5/1/2012,Francia,792,1686,0,2478
2012,Mayo,5,5/1/2012,Gabón,0,1,0,1
2012,Mayo,5,5/1/2012,Georgia,2,2,0,4
2012,Mayo,5,5/1/2012,Ghana,2,11,0,13
2012,Mayo,5,5/1/2012,Granada,1,0,0,1
2012,Mayo,5,5/1/2012,Grecia,13,49,0,62
2012,Mayo,5,5/1/2012,Guatemala,233,524,0,757
2012,Mayo,5,5/1/2012,Guyana,6,34,0,40
2012,Mayo,5,5/1/2012,Guinea,0,1,0,1
2012,Mayo,5,5/1/2012,Guinea Ecuatorial,1,0,0,1
2012,Mayo,5,5/1/2012,Guayana Francesa/Departamento de Ultramar Francés,0,3,0,3
2012,Mayo,5,5/1/2012,Haití,1,15,0,16
2012,Mayo,5,5/1/2012,Honduras,143,243,0,386
2012,Mayo,5,5/1/2012,Hong Kong,0,1,0,1
2012,Mayo,5,5/1/2012,Hungría,19,27,0,46
2012,Mayo,5,5/1/2012,India,57,301,0,358
2012,Mayo,5,5/1/2012,Indonesia,10,16,0,26
2012,Mayo,5,5/1/2012,Iraq,0,1,0,1
2012,Mayo,5,5/1/2012,Irán,3,21,0,24
2012,Mayo,5,5/1/2012,República de Irlanda,59,126,0,185
2012,Mayo,5,5/1/2012,Islandia,8,6,0,14
2012,Mayo,5,5/1/2012,Isla de Man,93,189,0,282
2012,Mayo,5,5/1/2012,Isla Johnston,0,2,0,2
2012,Mayo,5,5/1/2012,Israel,160,750,0,910
2012,Mayo,5,5/1/2012,Italia,435,1519,0,1954
2012,Mayo,5,5/1/2012,Jamaica,11,33,0,44
2012,Mayo,5,5/1/2012,Japón,164,498,0,662
2012,Mayo,5,5/1/2012,Jordania,3,7,0,10
2012,Mayo,5,5/1/2012,Kazajistán,5,3,0,8
2012,Mayo,5,5/1/2012,Kenia,4,8,0,12
2012,Mayo,5,5/1/2012,Kirguistán,1,0,0,1
2012,Mayo,5,5/1/2012,Kuwait,0,4,0,4
2012,Mayo,5,5/1/2012,Lesoto,1,0,0,1
2012,Mayo,5,5/1/2012,Letonia,4,8,0,12
2012,Mayo,5,5/1/2012,Lituania,9,10,0,19
2012,Mayo,5,5/1/2012,Líbano,13,34,0,47
2012,Mayo,5,5/1/2012,Liechtenstein,0,2,0,2
2012,Mayo,5,5/1/2012,Luxemburgo,4,4,0,8
2012,Mayo,5,5/1/2012,Macedonia,1,1,0,2
2012,Mayo,5,5/1/2012,Malasia,12,28,0,40
2012,Mayo,5,5/1/2012,Malawi,1,0,0,1
2012,Mayo,5,5/1/2012,Malta,2,5,0,7
2012,Mayo,5,5/1/2012,Marruecos,2,5,0,7
2012,Mayo,5,5/1/2012,Mauricio,1,0,0,1
2012,Mayo,5,5/1/2012,Mauritania,0,1,0,1
2012,Mayo,5,5/1/2012,México,1993,4599,0,6592
2012,Mayo,5,5/1/2012,República de Moldavia,2,1,0,3
2012,Mayo,5,5/1/2012,Mónaco,0,1,0,1
2012,Mayo,5,5/1/2012,Mongolia,1,1,0,2
2012,Mayo,5,5/1/2012,Mozambique,0,3,0,3
2012,Mayo,5,5/1/2012,Myanmar,0,1,0,1
2012,Mayo,5,5/1/2012,Nepal,0,8,0,8
2012,Mayo,5,5/1/2012,Nicaragua,76,70,0,146
2012,Mayo,5,5/1/2012,Nigeria,1,4,0,5
2012,Mayo,5,5/1/2012,Níger,1,1,0,2
2012,Mayo,5,5/1/2012,Noruega,55,86,0,141
2012,Mayo,5,5/1/2012,Nueva Zelanda,58,110,0,168
2012,Mayo,5,5/1/2012,Omán,1,1,0,2
2012,Mayo,5,5/1/2012,Pakistán,1,17,0,18
2012,Mayo,5,5/1/2012,Panamá,735,1406,0,2141
2012,Mayo,5,5/1/2012,Paraguay,72,93,0,165
2012,Mayo,5,5/1/2012,Perú,3139,4153,0,7292
2012,Mayo,5,5/1/2012,Polonia,52,80,0,132
2012,Mayo,5,5/1/2012,Portugal,74,336,0,410
2012,Mayo,5,5/1/2012,Puerto Rico/Territorio de Estados Unidos,2,1,0,3
2012,Mayo,5,5/1/2012,Qatar,1,1,0,2
2012,Mayo,5,5/1/2012,Reino Unido de Gran Bretaña e Irlanda del Norte,507,1297,0,1804
2012,Mayo,5,5/1/2012,Federación de Rusia,115,183,0,298
2012,Mayo,5,5/1/2012,República Dominicana,297,459,0,756
2012,Mayo,5,5/1/2012,Rumania,56,73,0,129
2012,Mayo,5,5/1/2012,San Cristóbal y Nevis,0,3,0,3
2012,Mayo,5,5/1/2012,San  Vicente y las Granadinas,1,2,0,3
2012,Mayo,5,5/1/2012,Santa Lucia,5,2,0,7
2012,Mayo,5,5/1/2012,Santa Sede/Ciudad del Vaticano,0,1,0,1
2012,Mayo,5,5/1/2012,Senegal,1,2,0,3
2012,Mayo,5,5/1/2012,Serbia,1,2,0,3
2012,Mayo,5,5/1/2012,Sierra Leona,0,1,0,1
2012,Mayo,5,5/1/2012,Singapur,12,17,0,29
2012,Mayo,5,5/1/2012,República Árabe Siria,4,0,0,4
2012,Mayo,5,5/1/2012,Sri Lanka,0,3,0,3
2012,Mayo,5,5/1/2012,Sudáfrica,46,100,0,146
2012,Mayo,5,5/1/2012,Sudán,1,2,0,3
2012,Mayo,5,5/1/2012,Suecia,147,229,0,376
2012,Mayo,5,5/1/2012,Suiza,251,496,0,747
2012,Mayo,5,5/1/2012,Surinam,7,27,0,34
2012,Mayo,5,5/1/2012,Taiwán,60,81,0,141
2012,Mayo,5,5/1/2012,Tailandia,8,20,0,28
2012,Mayo,5,5/1/2012,Tíbet/Región Autónoma de China,0,1,0,1
2012,Mayo,5,5/1/2012,Territorio Antártico Británico/Territorio Británico de Ultramar,1,6,0,7
2012,Mayo,5,5/1/2012,Tanzania,1,1,0,2
2012,Mayo,5,5/1/2012,Togo,0,1,0,1
2012,Mayo,5,5/1/2012,Trinidad y Tobago,25,125,0,150
2012,Mayo,5,5/1/2012,Túnez,3,4,0,7
2012,Mayo,5,5/1/2012,Turkmenistán,1,0,0,1
2012,Mayo,5,5/1/2012,Turquía,23,83,0,106
2012,Mayo,5,5/1/2012,Ucrania,12,20,0,32
2012,Mayo,5,5/1/2012,Uganda,3,1,0,4
2012,Mayo,5,5/1/2012,Uruguay,309,402,0,711
2012,Mayo,5,5/1/2012,Venezuela,6465,8885,0,15350
2012,Mayo,5,5/1/2012,Vietnam,3,11,0,14
2012,Mayo,5,5/1/2012,Islas Vírgenes Británicas/Territorio Británico de Ultramar,0,1,0,1
2012,Mayo,5,5/1/2012,República Árabe de Yemen,0,1,0,1
2012,Mayo,5,5/1/2012,Yugoslavia,1,1,0,2
2012,Mayo,5,5/1/2012,Zambia,2,1,0,3
2012,Mayo,5,5/1/2012,Zimbabue,0,2,0,2
2012,Mayo,5,5/1/2012,Desconocido,0,1,0,1
2012,Junio,6,6/1/2012,Albania,2,1,0,3
2012,Junio,6,6/1/2012,Alemania,1089,1710,0,2799
2012,Junio,6,6/1/2012,Andorra,0,12,0,12
2012,Junio,6,6/1/2012,Angola,1,3,0,4
2012,Junio,6,6/1/2012,Antigua y Barbuda,0,3,0,3
2012,Junio,6,6/1/2012,Países Bajos,884,1410,0,2294
2012,Junio,6,6/1/2012,Arabia Saudita,0,15,0,15
2012,Junio,6,6/1/2012,Argelia,1,6,0,7
2012,Junio,6,6/1/2012,Argentina,3065,4496,0,7561
2012,Junio,6,6/1/2012,República de Armenia,0,1,0,1
2012,Junio,6,6/1/2012,Aruba,4,3,0,7
2012,Junio,6,6/1/2012,Australia,320,535,0,855
2012,Junio,6,6/1/2012,Austria,109,173,0,282
2012,Junio,6,6/1/2012,Azerbaiyán,0,3,0,3
2012,Junio,6,6/1/2012,Bahamas,6,16,0,22
2012,Junio,6,6/1/2012,Bangladesh,0,3,0,3
2012,Junio,6,6/1/2012,Barbados,2,6,0,8
2012,Junio,6,6/1/2012,República de Belarús,2,5,0,7
2012,Junio,6,6/1/2012,Bélgica,188,395,0,583
2012,Junio,6,6/1/2012,Belice,4,23,0,27
2012,Junio,6,6/1/2012,Benín,1,0,0,1
2012,Junio,6,6/1/2012,Bermudas/Territorio Británico de Ultramar,1,1,0,2
2012,Junio,6,6/1/2012,Bolivia,311,446,0,757
2012,Junio,6,6/1/2012,Bosnia y Herzegovina,1,2,0,3
2012,Junio,6,6/1/2012,Botsuana,0,1,0,1
2012,Junio,6,6/1/2012,Brasil,2259,3850,0,6109
2012,Junio,6,6/1/2012,Brunei Darussalam,1,0,0,1
2012,Junio,6,6/1/2012,Bulgaria,8,8,0,16
2012,Junio,6,6/1/2012,Burkina Faso,1,2,0,3
2012,Junio,6,6/1/2012,Burundi,0,1,0,1
2012,Junio,6,6/1/2012,Bután,0,3,0,3
2012,Junio,6,6/1/2012,Islas Caimán/Territorio Británico de Ultramar,9,10,0,19
2012,Junio,6,6/1/2012,Camboya,0,2,0,2
2012,Junio,6,6/1/2012,Camerún,2,5,0,7
2012,Junio,6,6/1/2012,Canadá,771,1576,0,2347
2012,Junio,6,6/1/2012,Chad,0,1,0,1
2012,Junio,6,6/1/2012,España,2538,5696,0,8234
2012,Junio,6,6/1/2012,República Democrática del Congo,2,5,0,7
2012,Junio,6,6/1/2012,República de Corea,193,766,0,959
2012,Junio,6,6/1/2012,Costa de Marfil,0,2,0,2
2012,Junio,6,6/1/2012,Costa Rica,623,982,0,1605
2012,Junio,6,6/1/2012,Croacia,6,53,0,59
2012,Junio,6,6/1/2012,Cuba,104,197,0,301
2012,Junio,6,6/1/2012,Curazao,6,1,0,7
2012,Junio,6,6/1/2012,República Checa,46,92,0,138
2012,Junio,6,6/1/2012,Chile,2270,3445,0,5715
2012,Junio,6,6/1/2012,China,138,454,0,592
2012,Junio,6,6/1/2012,Chipre,2,5,0,7
2012,Junio,6,6/1/2012,Dinamarca,83,149,0,232
2012,Junio,6,6/1/2012,Dominica,1,3,0,4
2012,Junio,6,6/1/2012,Ecuador,2794,4844,0,7638
2012,Junio,6,6/1/2012,Egipto,2,12,0,14
2012,Junio,6,6/1/2012,El Salvador,345,639,0,984
2012,Junio,6,6/1/2012,Emiratos Árabes,2,7,0,9
2012,Junio,6,6/1/2012,Eritrea,0,1,0,1
2012,Junio,6,6/1/2012,Eslovaquia,10,21,0,31
2012,Junio,6,6/1/2012,Eslovenia,8,18,0,26
2012,Junio,6,6/1/2012,Estados Unidos de América,14348,22490,0,36838
2012,Junio,6,6/1/2012,Estonia,4,6,0,10
2012,Junio,6,6/1/2012,Etiopia,0,5,0,5
2012,Junio,6,6/1/2012,Filipinas,23,152,0,175
2012,Junio,6,6/1/2012,Finlandia,47,69,0,116
2012,Junio,6,6/1/2012,Francia,1063,1888,0,2951
2012,Junio,6,6/1/2012,Gabón,1,2,0,3
2012,Junio,6,6/1/2012,Georgia,1,2,0,3
2012,Junio,6,6/1/2012,Ghana,1,4,0,5
2012,Junio,6,6/1/2012,Granada,0,3,0,3
2012,Junio,6,6/1/2012,Grecia,18,54,0,72
2012,Junio,6,6/1/2012,Guatemala,337,686,0,1023
2012,Junio,6,6/1/2012,Guyana,7,17,0,24
2012,Junio,6,6/1/2012,Guinea,0,1,0,1
2012,Junio,6,6/1/2012,Guinea Ecuatorial,1,0,0,1
2012,Junio,6,6/1/2012,Haití,4,21,0,25
2012,Junio,6,6/1/2012,Honduras,139,326,0,465
2012,Junio,6,6/1/2012,Hungría,18,26,0,44
2012,Junio,6,6/1/2012,India,45,249,0,294
2012,Junio,6,6/1/2012,Indonesia,14,35,0,49
2012,Junio,6,6/1/2012,Irán,7,18,0,25
2012,Junio,6,6/1/2012,República de Irlanda,76,124,0,200
2012,Junio,6,6/1/2012,Islandia,10,3,0,13
2012,Junio,6,6/1/2012,Isla de Man,88,197,0,285
2012,Junio,6,6/1/2012,Israel,149,679,0,828
2012,Junio,6,6/1/2012,Islas Aland/Provincia de Finlandia,0,1,0,1
2012,Junio,6,6/1/2012,Italia,537,1693,0,2230
2012,Junio,6,6/1/2012,Islas del Canal,0,1,0,1
2012,Junio,6,6/1/2012,Jamaica,15,52,0,67
2012,Junio,6,6/1/2012,Islas Salomón,0,1,0,1
2012,Junio,6,6/1/2012,Japón,167,491,0,658
2012,Junio,6,6/1/2012,Jordania,0,5,0,5
2012,Junio,6,6/1/2012,Kazajistán,4,1,0,5
2012,Junio,6,6/1/2012,Kenia,6,22,0,28
2012,Junio,6,6/1/2012,Kuwait,0,7,0,7
2012,Junio,6,6/1/2012,República de Kosovo,1,0,0,1
2012,Junio,6,6/1/2012,República Democrática Popular  Lao,0,2,0,2
2012,Junio,6,6/1/2012,Letonia,5,8,0,13
2012,Junio,6,6/1/2012,Lituania,6,8,0,14
2012,Junio,6,6/1/2012,Líbano,11,37,0,48
2012,Junio,6,6/1/2012,Liberia,0,2,0,2
2012,Junio,6,6/1/2012,Libia,0,3,0,3
2012,Junio,6,6/1/2012,Luxemburgo,3,12,0,15
2012,Junio,6,6/1/2012,Macedonia,3,2,0,5
2012,Junio,6,6/1/2012,Madagascar,1,1,0,2
2012,Junio,6,6/1/2012,Malasia,11,27,0,38
2012,Junio,6,6/1/2012,Malta,2,1,0,3
2012,Junio,6,6/1/2012,Marruecos,3,6,0,9
2012,Junio,6,6/1/2012,Mauricio,0,1,0,1
2012,Junio,6,6/1/2012,Mauritania,0,2,0,2
2012,Junio,6,6/1/2012,México,1924,4471,0,6395
2012,Junio,6,6/1/2012,República de Moldavia,1,0,0,1
2012,Junio,6,6/1/2012,Mónaco,0,1,0,1
2012,Junio,6,6/1/2012,Mongolia,1,0,0,1
2012,Junio,6,6/1/2012,Mozambique,0,2,0,2
2012,Junio,6,6/1/2012,Namibia,0,1,0,1
2012,Junio,6,6/1/2012,Nepal,0,3,0,3
2012,Junio,6,6/1/2012,Nicaragua,68,98,0,166
2012,Junio,6,6/1/2012,Nigeria,4,13,0,17
2012,Junio,6,6/1/2012,Noruega,143,221,0,364
2012,Junio,6,6/1/2012,Nueva Zelanda,62,97,0,159
2012,Junio,6,6/1/2012,Omán,0,1,0,1
2012,Junio,6,6/1/2012,Papúa Nueva Guinea,1,2,0,3
2012,Junio,6,6/1/2012,Pakistán,0,14,0,14
2012,Junio,6,6/1/2012,Panamá,806,1414,0,2220
2012,Junio,6,6/1/2012,Paraguay,168,296,0,464
2012,Junio,6,6/1/2012,Perú,2654,3891,0,6545
2012,Junio,6,6/1/2012,Palestina,1,1,0,2
2012,Junio,6,6/1/2012,Polonia,78,107,0,185
2012,Junio,6,6/1/2012,Portugal,85,361,0,446
2012,Junio,6,6/1/2012,Puerto Rico/Territorio de Estados Unidos,4,12,0,16
2012,Junio,6,6/1/2012,Reino Unido de Gran Bretaña e Irlanda del Norte,591,1252,0,1843
2012,Junio,6,6/1/2012,República CentroÁfricana,0,2,0,2
2012,Junio,6,6/1/2012,Federación de Rusia,128,172,0,300
2012,Junio,6,6/1/2012,República Dominicana,291,474,0,765
2012,Junio,6,6/1/2012,Rumania,17,53,0,70
2012,Junio,6,6/1/2012,Rwanda,1,0,0,1
2012,Junio,6,6/1/2012,San Cristóbal y Nevis,0,6,0,6
2012,Junio,6,6/1/2012,Santa Lucia,2,5,0,7
2012,Junio,6,6/1/2012,Santa Sede/Ciudad del Vaticano,0,1,0,1
2012,Junio,6,6/1/2012,Senegal,0,2,0,2
2012,Junio,6,6/1/2012,Serbia,2,5,0,7
2012,Junio,6,6/1/2012,Sierra Leona,2,0,0,2
2012,Junio,6,6/1/2012,Singapur,7,12,0,19
2012,Junio,6,6/1/2012,República Árabe Siria,0,3,0,3
2012,Junio,6,6/1/2012,Somalia,0,1,0,1
2012,Junio,6,6/1/2012,Sri Lanka,2,0,0,2
2012,Junio,6,6/1/2012,Sudáfrica,22,96,0,118
2012,Junio,6,6/1/2012,Sudán,0,2,0,2
2012,Junio,6,6/1/2012,Suecia,224,283,0,507
2012,Junio,6,6/1/2012,Suiza,352,573,0,925
2012,Junio,6,6/1/2012,Surinam,5,21,0,26
2012,Junio,6,6/1/2012,Taiwán,34,75,0,109
2012,Junio,6,6/1/2012,Tailandia,4,5,0,9
2012,Junio,6,6/1/2012,Tíbet/Región Autónoma de China,0,2,0,2
2012,Junio,6,6/1/2012,Territorio Antártico Británico/Territorio Británico de Ultramar,2,4,0,6
2012,Junio,6,6/1/2012,Tanzania,1,5,0,6
2012,Junio,6,6/1/2012,Trinidad y Tobago,18,113,0,131
2012,Junio,6,6/1/2012,Túnez,2,4,0,6
2012,Junio,6,6/1/2012,Turquía,17,87,0,104
2012,Junio,6,6/1/2012,Ucrania,17,11,0,28
2012,Junio,6,6/1/2012,Uganda,1,3,0,4
2012,Junio,6,6/1/2012,Uruguay,324,510,0,834
2012,Junio,6,6/1/2012,Vanuatu,0,1,0,1
2012,Junio,6,6/1/2012,Venezuela,6595,8956,0,15551
2012,Junio,6,6/1/2012,Vietnam,1,9,0,10
2012,Junio,6,6/1/2012,Islas Vírgenes Británicas/Territorio Británico de Ultramar,0,1,0,1
2012,Junio,6,6/1/2012,Zambia,0,6,0,6
2012,Junio,6,6/1/2012,Zimbabue,2,7,0,9
2012,Julio,7,7/1/2012,Albania,0,4,0,4
2012,Julio,7,7/1/2012,Alemania,1713,2386,0,4099
2012,Julio,7,7/1/2012,Andorra,0,10,0,10
2012,Julio,7,7/1/2012,Angola,0,1,0,1
2012,Julio,7,7/1/2012,Antigua y Barbuda,2,2,0,4
2012,Julio,7,7/1/2012,Países Bajos,1626,2105,0,3731
2012,Julio,7,7/1/2012,Arabia Saudita,2,3,0,5
2012,Julio,7,7/1/2012,Argelia,1,3,0,4
2012,Julio,7,7/1/2012,Argentina,3741,5295,0,9036
2012,Julio,7,7/1/2012,Aruba,6,8,0,14
2012,Julio,7,7/1/2012,Australia,349,548,0,897
2012,Julio,7,7/1/2012,Austria,197,335,0,532
2012,Julio,7,7/1/2012,Azerbaiyán,7,20,0,27
2012,Julio,7,7/1/2012,Bahamas,7,10,0,17
2012,Julio,7,7/1/2012,Bangladesh,0,1,0,1
2012,Julio,7,7/1/2012,Barbados,7,5,0,12
2012,Julio,7,7/1/2012,República de Belarús,0,3,0,3
2012,Julio,7,7/1/2012,Bélgica,270,471,0,741
2012,Julio,7,7/1/2012,Belice,6,17,0,23
2012,Julio,7,7/1/2012,Bermudas/Territorio Británico de Ultramar,0,3,0,3
2012,Julio,7,7/1/2012,Bolivia,371,501,0,872
2012,Julio,7,7/1/2012,Bosnia y Herzegovina,1,2,0,3
2012,Julio,7,7/1/2012,Brasil,3589,4893,0,8482
2012,Julio,7,7/1/2012,Bulgaria,9,7,0,16
2012,Julio,7,7/1/2012,Burkina Faso,1,0,0,1
2012,Julio,7,7/1/2012,Islas Caimán/Territorio Británico de Ultramar,4,10,0,14
2012,Julio,7,7/1/2012,Camerún,0,1,0,1
2012,Julio,7,7/1/2012,Canadá,1354,2093,0,3447
2012,Julio,7,7/1/2012,España,2608,5260,0,7868
2012,Julio,7,7/1/2012,República Democrática del Congo,2,1,0,3
2012,Julio,7,7/1/2012,República de Corea,132,392,0,524
2012,Julio,7,7/1/2012,Costa Rica,961,1220,0,2181
2012,Julio,7,7/1/2012,Croacia,8,30,0,38
2012,Julio,7,7/1/2012,Cuba,142,282,0,424
2012,Julio,7,7/1/2012,Curazao,7,12,0,19
2012,Julio,7,7/1/2012,República Checa,26,53,0,79
2012,Julio,7,7/1/2012,Chile,2748,3669,0,6417
2012,Julio,7,7/1/2012,China,159,398,0,557
2012,Julio,7,7/1/2012,Chipre,5,1,0,6
2012,Julio,7,7/1/2012,Dinamarca,134,198,0,332
2012,Julio,7,7/1/2012,Dominica,4,3,0,7
2012,Julio,7,7/1/2012,Ecuador,5175,7052,0,12227
2012,Julio,7,7/1/2012,Egipto,6,24,0,30
2012,Julio,7,7/1/2012,El Salvador,435,644,0,1079
2012,Julio,7,7/1/2012,Emiratos Árabes,6,8,0,14
2012,Julio,7,7/1/2012,Eslovaquia,19,8,0,27
2012,Julio,7,7/1/2012,Eslovenia,32,27,0,59
2012,Julio,7,7/1/2012,Estados Unidos de América,12937,20362,0,33299
2012,Julio,7,7/1/2012,Estonia,5,1,0,6
2012,Julio,7,7/1/2012,Etiopia,3,3,0,6
2012,Julio,7,7/1/2012,Filipinas,24,129,0,153
2012,Julio,7,7/1/2012,Finlandia,40,62,0,102
2012,Julio,7,7/1/2012,Francia,1733,2699,0,4432
2012,Julio,7,7/1/2012,Gabón,1,0,0,1
2012,Julio,7,7/1/2012,Georgia,3,6,0,9
2012,Julio,7,7/1/2012,Ghana,1,4,0,5
2012,Julio,7,7/1/2012,Granada,1,1,0,2
2012,Julio,7,7/1/2012,Grecia,27,55,0,82
2012,Julio,7,7/1/2012,Guatemala,246,551,0,797
2012,Julio,7,7/1/2012,Guyana,2,9,0,11
2012,Julio,7,7/1/2012,Guinea Ecuatorial,1,0,0,1
2012,Julio,7,7/1/2012,Guayana Francesa/Departamento de Ultramar Francés,0,1,0,1
2012,Julio,7,7/1/2012,Haití,3,15,0,18
2012,Julio,7,7/1/2012,Honduras,205,411,0,616
2012,Julio,7,7/1/2012,Hungría,25,41,0,66
2012,Julio,7,7/1/2012,India,30,281,0,311
2012,Julio,7,7/1/2012,Indonesia,5,36,0,41
2012,Julio,7,7/1/2012,Irán,7,20,0,27
2012,Julio,7,7/1/2012,República de Irlanda,116,157,0,273
2012,Julio,7,7/1/2012,Islandia,6,10,0,16
2012,Julio,7,7/1/2012,Isla de Man,88,221,0,309
2012,Julio,7,7/1/2012,Isla Johnston,5,0,0,5
2012,Julio,7,7/1/2012,Israel,144,592,0,736
2012,Julio,7,7/1/2012,Islas Aland/Provincia de Finlandia,1,1,0,2
2012,Julio,7,7/1/2012,Italia,634,1740,0,2374
2012,Julio,7,7/1/2012,Jamaica,33,33,0,66
2012,Julio,7,7/1/2012,Islas Marianas del Norte,0,1,0,1
2012,Julio,7,7/1/2012,Japón,175,505,0,680
2012,Julio,7,7/1/2012,Jordania,0,4,0,4
2012,Julio,7,7/1/2012,Kazajistán,1,0,0,1
2012,Julio,7,7/1/2012,Kenia,8,14,0,22
2012,Julio,7,7/1/2012,Kirguistán,1,1,0,2
2012,Julio,7,7/1/2012,Kuwait,1,0,0,1
2012,Julio,7,7/1/2012,Letonia,5,22,0,27
2012,Julio,7,7/1/2012,Lituania,7,12,0,19
2012,Julio,7,7/1/2012,Líbano,27,37,0,64
2012,Julio,7,7/1/2012,Liechtenstein,4,5,0,9
2012,Julio,7,7/1/2012,Luxemburgo,10,9,0,19
2012,Julio,7,7/1/2012,Macedonia,2,2,0,4
2012,Julio,7,7/1/2012,Madagascar,1,0,0,1
2012,Julio,7,7/1/2012,Malasia,7,19,0,26
2012,Julio,7,7/1/2012,Malta,1,2,0,3
2012,Julio,7,7/1/2012,Marruecos,5,13,0,18
2012,Julio,7,7/1/2012,Mauricio,0,1,0,1
2012,Julio,7,7/1/2012,Mauritania,0,1,0,1
2012,Julio,7,7/1/2012,México,2892,5570,0,8462
2012,Julio,7,7/1/2012,República de Moldavia,2,0,0,2
2012,Julio,7,7/1/2012,Montenegro,1,2,0,3
2012,Julio,7,7/1/2012,Mozambique,1,0,0,1
2012,Julio,7,7/1/2012,Myanmar,0,1,0,1
2012,Julio,7,7/1/2012,Namibia,0,2,0,2
2012,Julio,7,7/1/2012,Nepal,0,2,0,2
2012,Julio,7,7/1/2012,Nicaragua,66,87,0,153
2012,Julio,7,7/1/2012,Nigeria,1,4,0,5
2012,Julio,7,7/1/2012,Noruega,128,178,0,306
2012,Julio,7,7/1/2012,Nueva Zelanda,77,128,0,205
2012,Julio,7,7/1/2012,Pakistán,1,17,0,18
2012,Julio,7,7/1/2012,Palau,0,1,0,1
2012,Julio,7,7/1/2012,Panamá,987,1636,0,2623
2012,Julio,7,7/1/2012,Paraguay,72,97,0,169
2012,Julio,7,7/1/2012,Perú,3018,4151,0,7169
2012,Julio,7,7/1/2012,Palestina,2,3,0,5
2012,Julio,7,7/1/2012,Polonia,74,83,0,157
2012,Julio,7,7/1/2012,Portugal,95,299,0,394
2012,Julio,7,7/1/2012,Puerto Rico/Territorio de Estados Unidos,4,6,0,10
2012,Julio,7,7/1/2012,Qatar,0,2,0,2
2012,Julio,7,7/1/2012,Reino Unido de Gran Bretaña e Irlanda del Norte,750,1474,0,2224
2012,Julio,7,7/1/2012,Federación de Rusia,119,152,0,271
2012,Julio,7,7/1/2012,República Dominicana,324,505,0,829
2012,Julio,7,7/1/2012,Rumania,28,51,0,79
2012,Julio,7,7/1/2012,Rwanda,1,0,0,1
2012,Julio,7,7/1/2012,San Cristóbal y Nevis,0,1,0,1
2012,Julio,7,7/1/2012,San Marino,0,1,0,1
2012,Julio,7,7/1/2012,San  Vicente y las Granadinas,0,2,0,2
2012,Julio,7,7/1/2012,Santa Lucia,6,3,0,9
2012,Julio,7,7/1/2012,Santa Sede/Ciudad del Vaticano,0,4,0,4
2012,Julio,7,7/1/2012,Senegal,0,1,0,1
2012,Julio,7,7/1/2012,Serbia,3,6,0,9
2012,Julio,7,7/1/2012,Sierra Leona,0,1,0,1
2012,Julio,7,7/1/2012,Singapur,7,16,0,23
2012,Julio,7,7/1/2012,República Árabe Siria,0,3,0,3
2012,Julio,7,7/1/2012,Sri Lanka,0,3,0,3
2012,Julio,7,7/1/2012,Sudáfrica,15,71,0,86
2012,Julio,7,7/1/2012,Sudán,0,1,0,1
2012,Julio,7,7/1/2012,Suecia,146,214,0,360
2012,Julio,7,7/1/2012,Suiza,757,961,0,1718
2012,Julio,7,7/1/2012,Surinam,18,11,0,29
2012,Julio,7,7/1/2012,Taiwán,35,65,0,100
2012,Julio,7,7/1/2012,Tailandia,9,3,0,12
2012,Julio,7,7/1/2012,Tíbet/Región Autónoma de China,1,1,0,2
2012,Julio,7,7/1/2012,Territorio Antártico Británico/Territorio Británico de Ultramar,2,7,0,9
2012,Julio,7,7/1/2012,Tanzania,0,2,0,2
2012,Julio,7,7/1/2012,Trinidad y Tobago,55,147,0,202
2012,Julio,7,7/1/2012,Túnez,1,2,0,3
2012,Julio,7,7/1/2012,Turkmenistán,0,1,0,1
2012,Julio,7,7/1/2012,Turquía,29,115,0,144
2012,Julio,7,7/1/2012,Ucrania,20,25,0,45
2012,Julio,7,7/1/2012,Uganda,0,3,0,3
2012,Julio,7,7/1/2012,Uruguay,346,491,0,837
2012,Julio,7,7/1/2012,Uzbekistán,2,0,0,2
2012,Julio,7,7/1/2012,Venezuela,9545,11592,0,21137
2012,Julio,7,7/1/2012,Vietnam,1,1,0,2
2012,Julio,7,7/1/2012,Yugoslavia,1,0,0,1
2012,Julio,7,7/1/2012,Zimbabue,0,4,0,4
2012,Julio,7,7/1/2012,Anguila/Territorio Británico de Ultramar,0,3,0,3
2012,Agosto,8,8/1/2012,Albania,1,0,0,1
2012,Agosto,8,8/1/2012,Alemania,1700,2331,0,4031
2012,Agosto,8,8/1/2012,Andorra,1,11,0,12
2012,Agosto,8,8/1/2012,Angola,0,2,0,2
2012,Agosto,8,8/1/2012,Antigua y Barbuda,1,5,0,6
2012,Agosto,8,8/1/2012,Países Bajos,753,1423,0,2176
2012,Agosto,8,8/1/2012,Arabia Saudita,1,3,0,4
2012,Agosto,8,8/1/2012,Argelia,3,4,0,7
2012,Agosto,8,8/1/2012,Argentina,3535,5116,0,8651
2012,Agosto,8,8/1/2012,República de Armenia,0,2,0,2
2012,Agosto,8,8/1/2012,Aruba,3,5,0,8
2012,Agosto,8,8/1/2012,Australia,335,555,0,890
2012,Agosto,8,8/1/2012,Austria,159,272,0,431
2012,Agosto,8,8/1/2012,Azerbaiyán,2,4,0,6
2012,Agosto,8,8/1/2012,Bahamas,5,9,0,14
2012,Agosto,8,8/1/2012,Bangladesh,0,2,0,2
2012,Agosto,8,8/1/2012,Barbados,5,6,0,11
2012,Agosto,8,8/1/2012,República de Belarús,1,3,0,4
2012,Agosto,8,8/1/2012,Bélgica,124,311,0,435
2012,Agosto,8,8/1/2012,Belice,4,10,0,14
2012,Agosto,8,8/1/2012,Benín,1,2,0,3
2012,Agosto,8,8/1/2012,Bermudas/Territorio Británico de Ultramar,0,1,0,1
2012,Agosto,8,8/1/2012,Bolivia,337,482,0,819
2012,Agosto,8,8/1/2012,Bosnia y Herzegovina,1,0,0,1
2012,Agosto,8,8/1/2012,Brasil,2409,4124,0,6533
2012,Agosto,8,8/1/2012,Bulgaria,17,26,0,43
2012,Agosto,8,8/1/2012,Islas Caimán/Territorio Británico de Ultramar,1,0,0,1
2012,Agosto,8,8/1/2012,Camerún,0,4,0,4
2012,Agosto,8,8/1/2012,Canadá,1028,1812,0,2840
2012,Agosto,8,8/1/2012,España,3030,5746,0,8776
2012,Agosto,8,8/1/2012,República Democrática del Congo,2,2,0,4
2012,Agosto,8,8/1/2012,República de Corea,159,325,0,484
2012,Agosto,8,8/1/2012,Costa de Marfil,0,1,0,1
2012,Agosto,8,8/1/2012,Costa Rica,785,1224,0,2009
2012,Agosto,8,8/1/2012,Croacia,8,37,0,45
2012,Agosto,8,8/1/2012,Cuba,116,274,0,390
2012,Agosto,8,8/1/2012,Curazao,4,7,0,11
2012,Agosto,8,8/1/2012,República Checa,33,42,0,75
2012,Agosto,8,8/1/2012,Chile,2537,3819,0,6356
2012,Agosto,8,8/1/2012,China,166,490,0,656
2012,Agosto,8,8/1/2012,Chipre,1,9,0,10
2012,Agosto,8,8/1/2012,Dinamarca,49,130,0,179
2012,Agosto,8,8/1/2012,Dominica,5,5,0,10
2012,Agosto,8,8/1/2012,Ecuador,5724,7539,0,13263
2012,Agosto,8,8/1/2012,Egipto,3,16,0,19
2012,Agosto,8,8/1/2012,El Salvador,492,701,0,1193
2012,Agosto,8,8/1/2012,Emiratos Árabes,0,1,0,1
2012,Agosto,8,8/1/2012,Eritrea,0,2,0,2
2012,Agosto,8,8/1/2012,Eslovaquia,31,15,0,46
2012,Agosto,8,8/1/2012,Eslovenia,8,19,0,27
2012,Agosto,8,8/1/2012,Estados Unidos de América,10494,19522,0,30016
2012,Agosto,8,8/1/2012,Estonia,6,7,0,13
2012,Agosto,8,8/1/2012,Etiopia,0,4,0,4
2012,Agosto,8,8/1/2012,Islas Fiji,1,0,0,1
2012,Agosto,8,8/1/2012,Filipinas,23,165,0,188
2012,Agosto,8,8/1/2012,Finlandia,39,60,0,99
2012,Agosto,8,8/1/2012,Francia,1541,2425,0,3966
2012,Agosto,8,8/1/2012,Gambia,0,1,0,1
2012,Agosto,8,8/1/2012,Georgia,0,1,0,1
2012,Agosto,8,8/1/2012,Ghana,0,2,0,2
2012,Agosto,8,8/1/2012,Granada,3,1,0,4
2012,Agosto,8,8/1/2012,Grecia,21,50,0,71
2012,Agosto,8,8/1/2012,Guatemala,281,613,0,894
2012,Agosto,8,8/1/2012,Guyana,3,17,0,20
2012,Agosto,8,8/1/2012,Guinea Ecuatorial,1,0,0,1
2012,Agosto,8,8/1/2012,Guayana Francesa/Departamento de Ultramar Francés,0,1,0,1
2012,Agosto,8,8/1/2012,Haití,9,19,0,28
2012,Agosto,8,8/1/2012,Honduras,189,280,0,469
2012,Agosto,8,8/1/2012,Hungría,19,37,0,56
2012,Agosto,8,8/1/2012,India,40,305,0,345
2012,Agosto,8,8/1/2012,Indonesia,7,8,0,15
2012,Agosto,8,8/1/2012,Iraq,2,0,0,2
2012,Agosto,8,8/1/2012,Irán,5,20,0,25
2012,Agosto,8,8/1/2012,República de Irlanda,89,153,0,242
2012,Agosto,8,8/1/2012,Islandia,8,13,0,21
2012,Agosto,8,8/1/2012,Isla de Man,69,166,0,235
2012,Agosto,8,8/1/2012,Isla Johnston,0,1,0,1
2012,Agosto,8,8/1/2012,Israel,138,531,0,669
2012,Agosto,8,8/1/2012,Islas Aland/Provincia de Finlandia,0,2,0,2
2012,Agosto,8,8/1/2012,Italia,838,2232,0,3070
2012,Agosto,8,8/1/2012,Jamaica,18,30,0,48
2012,Agosto,8,8/1/2012,Japón,204,536,0,740
2012,Agosto,8,8/1/2012,Jordania,1,3,0,4
2012,Agosto,8,8/1/2012,Kazajistán,0,1,0,1
2012,Agosto,8,8/1/2012,Kenia,7,12,0,19
2012,Agosto,8,8/1/2012,Kuwait,0,3,0,3
2012,Agosto,8,8/1/2012,Letonia,8,9,0,17
2012,Agosto,8,8/1/2012,Lituania,12,13,0,25
2012,Agosto,8,8/1/2012,Líbano,30,49,0,79
2012,Agosto,8,8/1/2012,Liechtenstein,2,3,0,5
2012,Agosto,8,8/1/2012,Luxemburgo,13,24,0,37
2012,Agosto,8,8/1/2012,Madagascar,0,2,0,2
2012,Agosto,8,8/1/2012,Malasia,10,24,0,34
2012,Agosto,8,8/1/2012,Malawi,0,1,0,1
2012,Agosto,8,8/1/2012,Malta,2,2,0,4
2012,Agosto,8,8/1/2012,Marruecos,4,11,0,15
2012,Agosto,8,8/1/2012,Mauricio,1,0,0,1
2012,Agosto,8,8/1/2012,México,2356,5344,0,7700
2012,Agosto,8,8/1/2012,República de Moldavia,3,0,0,3
2012,Agosto,8,8/1/2012,Mónaco,0,1,0,1
2012,Agosto,8,8/1/2012,Mongolia,0,1,0,1
2012,Agosto,8,8/1/2012,Mozambique,1,7,0,8
2012,Agosto,8,8/1/2012,Nepal,0,2,0,2
2012,Agosto,8,8/1/2012,Nicaragua,74,49,0,123
2012,Agosto,8,8/1/2012,Nigeria,1,3,0,4
2012,Agosto,8,8/1/2012,Noruega,56,126,0,182
2012,Agosto,8,8/1/2012,Nueva Zelanda,58,102,0,160
2012,Agosto,8,8/1/2012,Omán,1,0,0,1
2012,Agosto,8,8/1/2012,Papúa Nueva Guinea,0,1,0,1
2012,Agosto,8,8/1/2012,Pakistán,4,15,0,19
2012,Agosto,8,8/1/2012,Panamá,1038,1721,0,2759
2012,Agosto,8,8/1/2012,Paraguay,110,101,0,211
2012,Agosto,8,8/1/2012,Perú,3458,4592,0,8050
2012,Agosto,8,8/1/2012,Palestina,1,4,0,5
2012,Agosto,8,8/1/2012,Polonia,98,134,0,232
2012,Agosto,8,8/1/2012,Portugal,95,310,0,405
2012,Agosto,8,8/1/2012,Puerto Rico/Territorio de Estados Unidos,1,5,0,6
2012,Agosto,8,8/1/2012,Qatar,3,1,0,4
2012,Agosto,8,8/1/2012,Reino Unido de Gran Bretaña e Irlanda del Norte,677,1375,0,2052
2012,Agosto,8,8/1/2012,República CentroÁfricana,0,1,0,1
2012,Agosto,8,8/1/2012,Federación de Rusia,163,209,0,372
2012,Agosto,8,8/1/2012,República Dominicana,332,488,0,820
2012,Agosto,8,8/1/2012,Rumania,28,49,0,77
2012,Agosto,8,8/1/2012,Rwanda,0,1,0,1
2012,Agosto,8,8/1/2012,San Cristóbal y Nevis,1,4,0,5
2012,Agosto,8,8/1/2012,San  Vicente y las Granadinas,0,4,0,4
2012,Agosto,8,8/1/2012,Santa Lucia,8,3,0,11
2012,Agosto,8,8/1/2012,Serbia,3,3,0,6
2012,Agosto,8,8/1/2012,Sierra Leona,0,1,0,1
2012,Agosto,8,8/1/2012,Singapur,16,22,0,38
2012,Agosto,8,8/1/2012,República Árabe Siria,1,2,0,3
2012,Agosto,8,8/1/2012,Sri Lanka,1,3,0,4
2012,Agosto,8,8/1/2012,Sudáfrica,36,113,0,149
2012,Agosto,8,8/1/2012,Sudán,2,0,0,2
2012,Agosto,8,8/1/2012,Suecia,97,203,0,300
2012,Agosto,8,8/1/2012,Suiza,312,556,0,868
2012,Agosto,8,8/1/2012,Surinam,7,12,0,19
2012,Agosto,8,8/1/2012,Taiwán,41,82,0,123
2012,Agosto,8,8/1/2012,Tailandia,9,10,0,19
2012,Agosto,8,8/1/2012,Territorio Antártico Británico/Territorio Británico de Ultramar,0,8,0,8
2012,Agosto,8,8/1/2012,Tanzania,0,1,0,1
2012,Agosto,8,8/1/2012,Togo,0,2,0,2
2012,Agosto,8,8/1/2012,Trinidad y Tobago,97,144,0,241
2012,Agosto,8,8/1/2012,Túnez,2,6,0,8
2012,Agosto,8,8/1/2012,Turkmenistán,1,0,0,1
2012,Agosto,8,8/1/2012,Turquía,47,72,0,119
2012,Agosto,8,8/1/2012,Ucrania,19,21,0,40
2012,Agosto,8,8/1/2012,Uganda,5,1,0,6
2012,Agosto,8,8/1/2012,Uruguay,367,595,0,962
2012,Agosto,8,8/1/2012,Venezuela,15200,14824,0,30024
2012,Agosto,8,8/1/2012,Vietnam,3,3,0,6
2012,Agosto,8,8/1/2012,Yugoslavia,1,0,0,1
2012,Agosto,8,8/1/2012,Zambia,1,0,0,1
2012,Agosto,8,8/1/2012,Zimbabue,4,3,0,7
2012,Agosto,8,8/1/2012,Desconocido,0,1,0,1
2012,Septiembre,9,9/1/2012,Afganistán,0,1,0,1
2012,Septiembre,9,9/1/2012,Albania,2,4,0,6
2012,Septiembre,9,9/1/2012,Alemania,1120,1892,0,3012
2012,Septiembre,9,9/1/2012,Andorra,2,5,0,7
2012,Septiembre,9,9/1/2012,Angola,1,2,0,3
2012,Septiembre,9,9/1/2012,Antigua y Barbuda,0,2,0,2
2012,Septiembre,9,9/1/2012,Países Bajos,789,1386,0,2175
2012,Septiembre,9,9/1/2012,Arabia Saudita,0,2,0,2
2012,Septiembre,9,9/1/2012,Argelia,4,9,0,13
2012,Septiembre,9,9/1/2012,Argentina,3888,5405,0,9293
2012,Septiembre,9,9/1/2012,República de Armenia,2,2,0,4
2012,Septiembre,9,9/1/2012,Aruba,4,2,0,6
2012,Septiembre,9,9/1/2012,Australia,283,526,0,809
2012,Septiembre,9,9/1/2012,Austria,75,237,0,312
2012,Septiembre,9,9/1/2012,Azerbaiyán,1,2,0,3
2012,Septiembre,9,9/1/2012,Bahamas,0,36,0,36
2012,Septiembre,9,9/1/2012,Bangladesh,0,4,0,4
2012,Septiembre,9,9/1/2012,Barbados,1,10,0,11
2012,Septiembre,9,9/1/2012,República de Belarús,2,0,0,2
2012,Septiembre,9,9/1/2012,Bélgica,125,263,0,388
2012,Septiembre,9,9/1/2012,Belice,6,13,0,19
2012,Septiembre,9,9/1/2012,Benín,0,4,0,4
2012,Septiembre,9,9/1/2012,Bermudas/Territorio Británico de Ultramar,1,3,0,4
2012,Septiembre,9,9/1/2012,Bolivia,411,554,0,965
2012,Septiembre,9,9/1/2012,Bosnia y Herzegovina,0,1,0,1
2012,Septiembre,9,9/1/2012,Brasil,2802,4474,0,7276
2012,Septiembre,9,9/1/2012,Bulgaria,7,24,0,31
2012,Septiembre,9,9/1/2012,Burundi,0,1,0,1
2012,Septiembre,9,9/1/2012,Cabo Verde,0,3,0,3
2012,Septiembre,9,9/1/2012,Islas Caimán/Territorio Británico de Ultramar,1,2,0,3
2012,Septiembre,9,9/1/2012,Camerún,2,3,0,5
2012,Septiembre,9,9/1/2012,Canadá,643,1569,0,2212
2012,Septiembre,9,9/1/2012,España,2298,5735,0,8033
2012,Septiembre,9,9/1/2012,República de Corea,104,412,0,516
2012,Septiembre,9,9/1/2012,Costa de Marfil,0,2,0,2
2012,Septiembre,9,9/1/2012,Costa Rica,847,1196,0,2043
2012,Septiembre,9,9/1/2012,Croacia,6,29,0,35
2012,Septiembre,9,9/1/2012,Cuba,113,263,0,376
2012,Septiembre,9,9/1/2012,Curazao,7,12,0,19
2012,Septiembre,9,9/1/2012,República Checa,28,61,0,89
2012,Septiembre,9,9/1/2012,Chile,3150,4283,0,7433
2012,Septiembre,9,9/1/2012,China,187,486,0,673
2012,Septiembre,9,9/1/2012,Chipre,4,2,0,6
2012,Septiembre,9,9/1/2012,Dinamarca,51,135,0,186
2012,Septiembre,9,9/1/2012,Dominica,4,9,0,13
2012,Septiembre,9,9/1/2012,Ecuador,3552,5626,0,9178
2012,Septiembre,9,9/1/2012,Egipto,1,10,0,11
2012,Septiembre,9,9/1/2012,El Salvador,442,836,0,1278
2012,Septiembre,9,9/1/2012,Emiratos Árabes,1,13,0,14
2012,Septiembre,9,9/1/2012,Eslovaquia,16,19,0,35
2012,Septiembre,9,9/1/2012,Eslovenia,8,23,0,31
2012,Septiembre,9,9/1/2012,Estados Unidos de América,6498,15202,0,21700
2012,Septiembre,9,9/1/2012,Estonia,1,7,0,8
2012,Septiembre,9,9/1/2012,Etiopia,3,4,0,7
2012,Septiembre,9,9/1/2012,Filipinas,23,219,0,242
2012,Septiembre,9,9/1/2012,Finlandia,32,70,0,102
2012,Septiembre,9,9/1/2012,Francia,779,1740,0,2519
2012,Septiembre,9,9/1/2012,Georgia,4,0,0,4
2012,Septiembre,9,9/1/2012,Ghana,0,3,0,3
2012,Septiembre,9,9/1/2012,Granada,0,3,0,3
2012,Septiembre,9,9/1/2012,Grecia,15,55,0,70
2012,Septiembre,9,9/1/2012,Guatemala,338,893,0,1231
2012,Septiembre,9,9/1/2012,Guyana,2,18,0,20
2012,Septiembre,9,9/1/2012,Haití,10,18,0,28
2012,Septiembre,9,9/1/2012,Honduras,176,307,0,483
2012,Septiembre,9,9/1/2012,Hungría,24,47,0,71
2012,Septiembre,9,9/1/2012,India,31,312,0,343
2012,Septiembre,9,9/1/2012,Indonesia,7,60,0,67
2012,Septiembre,9,9/1/2012,Irán,3,14,0,17
2012,Septiembre,9,9/1/2012,República de Irlanda,78,127,0,205
2012,Septiembre,9,9/1/2012,Islandia,5,13,0,18
2012,Septiembre,9,9/1/2012,Isla de Man,49,163,0,212
2012,Septiembre,9,9/1/2012,Israel,126,484,0,610
2012,Septiembre,9,9/1/2012,Islas Aland/Provincia de Finlandia,0,1,0,1
2012,Septiembre,9,9/1/2012,Italia,430,1648,0,2078
2012,Septiembre,9,9/1/2012,Islas del Canal,1,1,0,2
2012,Septiembre,9,9/1/2012,Jamaica,12,11,0,23
2012,Septiembre,9,9/1/2012,Japón,164,498,0,662
2012,Septiembre,9,9/1/2012,Jordania,5,6,0,11
2012,Septiembre,9,9/1/2012,Kazajistán,4,3,0,7
2012,Septiembre,9,9/1/2012,Kenia,5,16,0,21
2012,Septiembre,9,9/1/2012,Kuwait,0,1,0,1
2012,Septiembre,9,9/1/2012,Letonia,4,26,0,30
2012,Septiembre,9,9/1/2012,Lituania,3,18,0,21
2012,Septiembre,9,9/1/2012,Líbano,32,49,0,81
2012,Septiembre,9,9/1/2012,Libia,0,2,0,2
2012,Septiembre,9,9/1/2012,Liechtenstein,0,3,0,3
2012,Septiembre,9,9/1/2012,Luxemburgo,3,8,0,11
2012,Septiembre,9,9/1/2012,Macedonia,0,1,0,1
2012,Septiembre,9,9/1/2012,Madagascar,1,0,0,1
2012,Septiembre,9,9/1/2012,Malasia,26,71,0,97
2012,Septiembre,9,9/1/2012,Malta,0,2,0,2
2012,Septiembre,9,9/1/2012,Marruecos,11,7,0,18
2012,Septiembre,9,9/1/2012,Mauricio,0,1,0,1
2012,Septiembre,9,9/1/2012,Mauritania,3,1,0,4
2012,Septiembre,9,9/1/2012,México,2166,5659,0,7825
2012,Septiembre,9,9/1/2012,República de Moldavia,2,0,0,2
2012,Septiembre,9,9/1/2012,Mongolia,1,0,0,1
2012,Septiembre,9,9/1/2012,Mozambique,0,2,0,2
2012,Septiembre,9,9/1/2012,Namibia,1,0,0,1
2012,Septiembre,9,9/1/2012,Nepal,0,1,0,1
2012,Septiembre,9,9/1/2012,Nicaragua,80,148,0,228
2012,Septiembre,9,9/1/2012,Nigeria,2,10,0,12
2012,Septiembre,9,9/1/2012,Noruega,45,122,0,167
2012,Septiembre,9,9/1/2012,Nueva Caledonia/Territorio francés,0,1,0,1
2012,Septiembre,9,9/1/2012,Nueva Zelanda,60,101,0,161
2012,Septiembre,9,9/1/2012,Pakistán,2,9,0,11
2012,Septiembre,9,9/1/2012,Panamá,1080,1616,0,2696
2012,Septiembre,9,9/1/2012,Paraguay,125,189,0,314
2012,Septiembre,9,9/1/2012,Perú,3064,4605,0,7669
2012,Septiembre,9,9/1/2012,Palestina,2,1,0,3
2012,Septiembre,9,9/1/2012,Polonia,63,125,0,188
2012,Septiembre,9,9/1/2012,Portugal,106,386,0,492
2012,Septiembre,9,9/1/2012,Puerto Rico/Territorio de Estados Unidos,0,4,0,4
2012,Septiembre,9,9/1/2012,Qatar,0,1,0,1
2012,Septiembre,9,9/1/2012,Reino Unido de Gran Bretaña e Irlanda del Norte,514,1279,0,1793
2012,Septiembre,9,9/1/2012,República CentroÁfricana,1,2,0,3
2012,Septiembre,9,9/1/2012,Federación de Rusia,145,183,0,328
2012,Septiembre,9,9/1/2012,República Dominicana,324,669,0,993
2012,Septiembre,9,9/1/2012,Rumania,37,71,0,108
2012,Septiembre,9,9/1/2012,San Cristóbal y Nevis,0,5,0,5
2012,Septiembre,9,9/1/2012,Santa Lucia,3,4,0,7
2012,Septiembre,9,9/1/2012,Senegal,1,2,0,3
2012,Septiembre,9,9/1/2012,Serbia,2,6,0,8
2012,Septiembre,9,9/1/2012,Sierra Leona,0,1,0,1
2012,Septiembre,9,9/1/2012,Singapur,17,23,0,40
2012,Septiembre,9,9/1/2012,República Árabe Siria,2,2,0,4
2012,Septiembre,9,9/1/2012,Sri Lanka,1,1,0,2
2012,Septiembre,9,9/1/2012,Sudáfrica,26,71,0,97
2012,Septiembre,9,9/1/2012,Suecia,116,213,0,329
2012,Septiembre,9,9/1/2012,Suiza,223,530,0,753
2012,Septiembre,9,9/1/2012,Surinam,16,17,0,33
2012,Septiembre,9,9/1/2012,Taiwán,71,114,0,185
2012,Septiembre,9,9/1/2012,Tailandia,8,9,0,17
2012,Septiembre,9,9/1/2012,Territorio Antártico Británico/Territorio Británico de Ultramar,1,8,0,9
2012,Septiembre,9,9/1/2012,Tanzania,0,2,0,2
2012,Septiembre,9,9/1/2012,Trinidad y Tobago,98,142,0,240
2012,Septiembre,9,9/1/2012,Túnez,0,2,0,2
2012,Septiembre,9,9/1/2012,Turkmenistán,1,0,0,1
2012,Septiembre,9,9/1/2012,Turquía,13,81,0,94
2012,Septiembre,9,9/1/2012,Ucrania,17,16,0,33
2012,Septiembre,9,9/1/2012,Uganda,0,3,0,3
2012,Septiembre,9,9/1/2012,Uruguay,319,697,0,1016
2012,Septiembre,9,9/1/2012,Uzbekistán,0,1,0,1
2012,Septiembre,9,9/1/2012,Venezuela,10526,11949,0,22475
2012,Septiembre,9,9/1/2012,Zimbabue,0,1,0,1
2012,Octubre,10,10/1/2012,Albania,1,6,0,7
2012,Octubre,10,10/1/2012,Alemania,1085,2044,0,3129
2012,Octubre,10,10/1/2012,Andorra,3,8,0,11
2012,Octubre,10,10/1/2012,Angola,1,2,0,3
2012,Octubre,10,10/1/2012,Antigua y Barbuda,4,2,0,6
2012,Octubre,10,10/1/2012,Países Bajos,903,1493,0,2396
2012,Octubre,10,10/1/2012,Arabia Saudita,0,8,0,8
2012,Octubre,10,10/1/2012,Argelia,1,2,0,3
2012,Octubre,10,10/1/2012,Argentina,3807,5428,0,9235
2012,Octubre,10,10/1/2012,República de Armenia,0,2,0,2
2012,Octubre,10,10/1/2012,Aruba,2,3,0,5
2012,Octubre,10,10/1/2012,Australia,305,570,0,875
2012,Octubre,10,10/1/2012,Austria,102,212,0,314
2012,Octubre,10,10/1/2012,Azerbaiyán,2,1,0,3
2012,Octubre,10,10/1/2012,Bahamas,5,2,0,7
2012,Octubre,10,10/1/2012,Bangladesh,1,5,0,6
2012,Octubre,10,10/1/2012,Barbados,2,5,0,7
2012,Octubre,10,10/1/2012,República de Belarús,9,13,0,22
2012,Octubre,10,10/1/2012,Bélgica,102,355,0,457
2012,Octubre,10,10/1/2012,Belice,5,18,0,23
2012,Octubre,10,10/1/2012,Benín,1,0,0,1
2012,Octubre,10,10/1/2012,Bermudas/Territorio Británico de Ultramar,0,1,0,1
2012,Octubre,10,10/1/2012,Bolivia,341,546,0,887
2012,Octubre,10,10/1/2012,Bosnia y Herzegovina,1,1,0,2
2012,Octubre,10,10/1/2012,Brasil,2587,4458,0,7045
2012,Octubre,10,10/1/2012,Brunei Darussalam,4,2,0,6
2012,Octubre,10,10/1/2012,Bulgaria,7,12,0,19
2012,Octubre,10,10/1/2012,Cabo Verde,1,0,0,1
2012,Octubre,10,10/1/2012,Camboya,2,2,0,4
2012,Octubre,10,10/1/2012,Camerún,0,25,0,25
2012,Octubre,10,10/1/2012,Canadá,694,1689,0,2383
2012,Octubre,10,10/1/2012,España,2387,6103,0,8490
2012,Octubre,10,10/1/2012,República Democrática del Congo,4,2,0,6
2012,Octubre,10,10/1/2012,República de Corea,113,446,0,559
2012,Octubre,10,10/1/2012,Costa de Marfil,3,5,0,8
2012,Octubre,10,10/1/2012,Costa Rica,814,1227,0,2041
2012,Octubre,10,10/1/2012,Croacia,8,35,0,43
2012,Octubre,10,10/1/2012,Cuba,161,258,0,419
2012,Octubre,10,10/1/2012,Curazao,3,2,0,5
2012,Octubre,10,10/1/2012,República Checa,23,54,0,77
2012,Octubre,10,10/1/2012,Chile,2819,4208,0,7027
2012,Octubre,10,10/1/2012,China,215,604,0,819
2012,Octubre,10,10/1/2012,Chipre,2,4,0,6
2012,Octubre,10,10/1/2012,Dinamarca,68,139,0,207
2012,Octubre,10,10/1/2012,Dominica,2,3,0,5
2012,Octubre,10,10/1/2012,Ecuador,3682,6108,0,9790
2012,Octubre,10,10/1/2012,Egipto,6,15,0,21
2012,Octubre,10,10/1/2012,El Salvador,487,784,0,1271
2012,Octubre,10,10/1/2012,Emiratos Árabes,0,1,0,1
2012,Octubre,10,10/1/2012,Eritrea,0,1,0,1
2012,Octubre,10,10/1/2012,Eslovaquia,10,10,0,20
2012,Octubre,10,10/1/2012,Eslovenia,17,22,0,39
2012,Octubre,10,10/1/2012,Estados Unidos de América,6537,15410,0,21947
2012,Octubre,10,10/1/2012,Estonia,8,14,0,22
2012,Octubre,10,10/1/2012,Etiopia,3,2,0,5
2012,Octubre,10,10/1/2012,Filipinas,23,193,0,216
2012,Octubre,10,10/1/2012,Finlandia,51,97,0,148
2012,Octubre,10,10/1/2012,Francia,1044,2033,0,3077
2012,Octubre,10,10/1/2012,Gabón,1,2,0,3
2012,Octubre,10,10/1/2012,Georgia,1,0,0,1
2012,Octubre,10,10/1/2012,Ghana,1,3,0,4
2012,Octubre,10,10/1/2012,Granada,0,1,0,1
2012,Octubre,10,10/1/2012,Grecia,14,69,0,83
2012,Octubre,10,10/1/2012,Guatemala,309,630,0,939
2012,Octubre,10,10/1/2012,Guyana,6,14,0,20
2012,Octubre,10,10/1/2012,Guayana Francesa/Departamento de Ultramar Francés,0,1,0,1
2012,Octubre,10,10/1/2012,Haití,6,76,0,82
2012,Octubre,10,10/1/2012,Honduras,174,320,0,494
2012,Octubre,10,10/1/2012,Hong Kong,0,1,0,1
2012,Octubre,10,10/1/2012,Hungría,13,27,0,40
2012,Octubre,10,10/1/2012,India,37,289,0,326
2012,Octubre,10,10/1/2012,Indonesia,9,27,0,36
2012,Octubre,10,10/1/2012,Iraq,7,5,0,12
2012,Octubre,10,10/1/2012,Irán,6,14,0,20
2012,Octubre,10,10/1/2012,República de Irlanda,59,139,0,198
2012,Octubre,10,10/1/2012,Islandia,6,15,0,21
2012,Octubre,10,10/1/2012,Isla de Man,68,177,0,245
2012,Octubre,10,10/1/2012,Isla Johnston,0,2,0,2
2012,Octubre,10,10/1/2012,Israel,100,524,0,624
2012,Octubre,10,10/1/2012,Islas Aland/Provincia de Finlandia,0,2,0,2
2012,Octubre,10,10/1/2012,Italia,484,1851,0,2335
2012,Octubre,10,10/1/2012,Islas del Canal,0,1,0,1
2012,Octubre,10,10/1/2012,Jamaica,18,39,0,57
2012,Octubre,10,10/1/2012,Japón,101,528,0,629
2012,Octubre,10,10/1/2012,Jordania,1,7,0,8
2012,Octubre,10,10/1/2012,Kazajistán,0,6,0,6
2012,Octubre,10,10/1/2012,Kenia,5,18,0,23
2012,Octubre,10,10/1/2012,Kirguistán,1,1,0,2
2012,Octubre,10,10/1/2012,Letonia,2,12,0,14
2012,Octubre,10,10/1/2012,Lituania,13,15,0,28
2012,Octubre,10,10/1/2012,Líbano,21,44,0,65
2012,Octubre,10,10/1/2012,Libia,0,1,0,1
2012,Octubre,10,10/1/2012,Liechtenstein,0,2,0,2
2012,Octubre,10,10/1/2012,Luxemburgo,3,13,0,16
2012,Octubre,10,10/1/2012,Macedonia,0,1,0,1
2012,Octubre,10,10/1/2012,Madagascar,1,2,0,3
2012,Octubre,10,10/1/2012,Malasia,15,20,0,35
2012,Octubre,10,10/1/2012,Malawi,0,1,0,1
2012,Octubre,10,10/1/2012,Malí,0,1,0,1
2012,Octubre,10,10/1/2012,Malta,2,0,0,2
2012,Octubre,10,10/1/2012,Marruecos,3,7,0,10
2012,Octubre,10,10/1/2012,Mauricio,1,1,0,2
2012,Octubre,10,10/1/2012,México,2364,5540,0,7904
2012,Octubre,10,10/1/2012,República de Moldavia,3,1,0,4
2012,Octubre,10,10/1/2012,Mongolia,2,1,0,3
2012,Octubre,10,10/1/2012,Myanmar,0,1,0,1
2012,Octubre,10,10/1/2012,Namibia,1,4,0,5
2012,Octubre,10,10/1/2012,Nepal,1,1,0,2
2012,Octubre,10,10/1/2012,Nicaragua,106,125,0,231
2012,Octubre,10,10/1/2012,Nigeria,3,8,0,11
2012,Octubre,10,10/1/2012,Noruega,55,134,0,189
2012,Octubre,10,10/1/2012,Nueva Zelanda,67,110,0,177
2012,Octubre,10,10/1/2012,Pakistán,1,13,0,14
2012,Octubre,10,10/1/2012,Panamá,957,1614,0,2571
2012,Octubre,10,10/1/2012,Paraguay,228,351,0,579
2012,Octubre,10,10/1/2012,Perú,3316,4735,0,8051
2012,Octubre,10,10/1/2012,Palestina,2,4,0,6
2012,Octubre,10,10/1/2012,Polonia,84,139,0,223
2012,Octubre,10,10/1/2012,Portugal,116,362,0,478
2012,Octubre,10,10/1/2012,Puerto Rico/Territorio de Estados Unidos,1,5,0,6
2012,Octubre,10,10/1/2012,Reino Unido de Gran Bretaña e Irlanda del Norte,517,1452,0,1969
2012,Octubre,10,10/1/2012,República CentroÁfricana,0,2,0,2
2012,Octubre,10,10/1/2012,Federación de Rusia,152,288,0,440
2012,Octubre,10,10/1/2012,República Dominicana,335,510,0,845
2012,Octubre,10,10/1/2012,Rumania,39,67,0,106
2012,Octubre,10,10/1/2012,Rwanda,0,3,0,3
2012,Octubre,10,10/1/2012,San Cristóbal y Nevis,0,1,0,1
2012,Octubre,10,10/1/2012,Samoa Estadounidense/Territorio no incorporado de Estados Unidos,0,1,0,1
2012,Octubre,10,10/1/2012,San  Vicente y las Granadinas,2,3,0,5
2012,Octubre,10,10/1/2012,Santa Lucia,12,6,0,18
2012,Octubre,10,10/1/2012,Santa Sede/Ciudad del Vaticano,0,1,0,1
2012,Octubre,10,10/1/2012,Senegal,4,4,0,8
2012,Octubre,10,10/1/2012,Serbia,3,7,0,10
2012,Octubre,10,10/1/2012,Singapur,9,15,0,24
2012,Octubre,10,10/1/2012,República Árabe Siria,0,5,0,5
2012,Octubre,10,10/1/2012,Sri Lanka,0,4,0,4
2012,Octubre,10,10/1/2012,Sudáfrica,29,94,0,123
2012,Octubre,10,10/1/2012,Sudán,0,1,0,1
2012,Octubre,10,10/1/2012,Suecia,140,286,0,426
2012,Octubre,10,10/1/2012,Suiza,278,636,0,914
2012,Octubre,10,10/1/2012,Surinam,15,24,0,39
2012,Octubre,10,10/1/2012,Taiwán,36,76,0,112
2012,Octubre,10,10/1/2012,Tailandia,6,8,0,14
2012,Octubre,10,10/1/2012,Territorio Antártico Británico/Territorio Británico de Ultramar,0,1,0,1
2012,Octubre,10,10/1/2012,Tanzania,0,3,0,3
2012,Octubre,10,10/1/2012,Togo,0,2,0,2
2012,Octubre,10,10/1/2012,Trinidad y Tobago,18,122,0,140
2012,Octubre,10,10/1/2012,Túnez,1,1,0,2
2012,Octubre,10,10/1/2012,Turquía,48,94,0,142
2012,Octubre,10,10/1/2012,Ucrania,24,32,0,56
2012,Octubre,10,10/1/2012,Uganda,2,1,0,3
2012,Octubre,10,10/1/2012,Uruguay,276,489,0,765
2012,Octubre,10,10/1/2012,Venezuela,8052,10717,0,18769
2012,Octubre,10,10/1/2012,Vietnam,2,6,0,8
2012,Octubre,10,10/1/2012,República Árabe de Yemen,0,1,0,1
2012,Octubre,10,10/1/2012,Yugoslavia,1,0,0,1
2012,Octubre,10,10/1/2012,Zambia,0,1,0,1
2012,Octubre,10,10/1/2012,Zimbabue,1,0,0,1
2012,Octubre,10,10/1/2012,Desconocido,1,0,0,1
2012,Noviembre,11,11/1/2012,Afganistán,0,2,0,2
2012,Noviembre,11,11/1/2012,Albania,1,2,0,3
2012,Noviembre,11,11/1/2012,Alemania,1382,2398,0,3780
2012,Noviembre,11,11/1/2012,Andorra,0,12,0,12
2012,Noviembre,11,11/1/2012,Angola,1,0,0,1
2012,Noviembre,11,11/1/2012,Antigua y Barbuda,0,4,0,4
2012,Noviembre,11,11/1/2012,Países Bajos,884,1607,0,2491
2012,Noviembre,11,11/1/2012,Arabia Saudita,1,3,0,4
2012,Noviembre,11,11/1/2012,Argelia,0,3,0,3
2012,Noviembre,11,11/1/2012,Argentina,3849,5158,0,9007
2012,Noviembre,11,11/1/2012,República de Armenia,2,1,0,3
2012,Noviembre,11,11/1/2012,Aruba,6,4,0,10
2012,Noviembre,11,11/1/2012,Australia,377,665,0,1042
2012,Noviembre,11,11/1/2012,Austria,132,280,0,412
2012,Noviembre,11,11/1/2012,Azerbaiyán,0,1,0,1
2012,Noviembre,11,11/1/2012,Bahamas,6,14,0,20
2012,Noviembre,11,11/1/2012,Bangladesh,1,1,0,2
2012,Noviembre,11,11/1/2012,Barbados,4,9,0,13
2012,Noviembre,11,11/1/2012,República de Belarús,4,3,0,7
2012,Noviembre,11,11/1/2012,Bélgica,134,336,0,470
2012,Noviembre,11,11/1/2012,Belice,2,8,0,10
2012,Noviembre,11,11/1/2012,Benín,1,0,0,1
2012,Noviembre,11,11/1/2012,Bermudas/Territorio Británico de Ultramar,1,2,0,3
2012,Noviembre,11,11/1/2012,Bolivia,425,639,0,1064
2012,Noviembre,11,11/1/2012,Bosnia y Herzegovina,0,2,0,2
2012,Noviembre,11,11/1/2012,Botsuana,2,0,0,2
2012,Noviembre,11,11/1/2012,Brasil,2384,4020,0,6404
2012,Noviembre,11,11/1/2012,Bulgaria,7,16,0,23
2012,Noviembre,11,11/1/2012,Burundi,0,2,0,2
2012,Noviembre,11,11/1/2012,Islas Caimán/Territorio Británico de Ultramar,1,1,0,2
2012,Noviembre,11,11/1/2012,Camboya,1,3,0,4
2012,Noviembre,11,11/1/2012,Camerún,1,5,0,6
2012,Noviembre,11,11/1/2012,Canadá,1028,2048,0,3076
2012,Noviembre,11,11/1/2012,España,2384,6552,0,8936
2012,Noviembre,11,11/1/2012,República Democrática del Congo,6,1,0,7
2012,Noviembre,11,11/1/2012,República de Corea,161,562,0,723
2012,Noviembre,11,11/1/2012,Costa de Marfil,1,1,0,2
2012,Noviembre,11,11/1/2012,Costa Rica,848,1189,0,2037
2012,Noviembre,11,11/1/2012,Croacia,2,35,0,37
2012,Noviembre,11,11/1/2012,Cuba,126,207,0,333
2012,Noviembre,11,11/1/2012,Curazao,13,11,0,24
2012,Noviembre,11,11/1/2012,República Checa,32,40,0,72
2012,Noviembre,11,11/1/2012,Chile,2340,3619,0,5959
2012,Noviembre,11,11/1/2012,China,182,566,0,748
2012,Noviembre,11,11/1/2012,Chipre,0,3,0,3
2012,Noviembre,11,11/1/2012,Dinamarca,94,156,0,250
2012,Noviembre,11,11/1/2012,Dominica,3,6,0,9
2012,Noviembre,11,11/1/2012,Ecuador,3950,5680,0,9630
2012,Noviembre,11,11/1/2012,Egipto,2,13,0,15
2012,Noviembre,11,11/1/2012,El Salvador,510,810,0,1320
2012,Noviembre,11,11/1/2012,Emiratos Árabes,1,3,0,4
2012,Noviembre,11,11/1/2012,Eslovaquia,21,20,0,41
2012,Noviembre,11,11/1/2012,Eslovenia,19,35,0,54
2012,Noviembre,11,11/1/2012,Estados Unidos de América,7818,16923,0,24741
2012,Noviembre,11,11/1/2012,Estonia,5,17,0,22
2012,Noviembre,11,11/1/2012,Etiopia,2,3,0,5
2012,Noviembre,11,11/1/2012,Islas Fiji,0,1,0,1
2012,Noviembre,11,11/1/2012,Filipinas,16,176,0,192
2012,Noviembre,11,11/1/2012,Finlandia,37,92,0,129
2012,Noviembre,11,11/1/2012,Francia,1043,2112,0,3155
2012,Noviembre,11,11/1/2012,Gabón,0,2,0,2
2012,Noviembre,11,11/1/2012,Georgia,2,5,0,7
2012,Noviembre,11,11/1/2012,Ghana,0,11,0,11
2012,Noviembre,11,11/1/2012,Granada,1,3,0,4
2012,Noviembre,11,11/1/2012,Grecia,31,78,0,109
2012,Noviembre,11,11/1/2012,Guatemala,329,720,0,1049
2012,Noviembre,11,11/1/2012,Guyana,4,17,0,21
2012,Noviembre,11,11/1/2012,Guinea Ecuatorial,0,1,0,1
2012,Noviembre,11,11/1/2012,Guayana Francesa/Departamento de Ultramar Francés,0,1,0,1
2012,Noviembre,11,11/1/2012,Haití,13,31,0,44
2012,Noviembre,11,11/1/2012,Honduras,204,278,0,482
2012,Noviembre,11,11/1/2012,Hungría,20,32,0,52
2012,Noviembre,11,11/1/2012,India,34,284,0,318
2012,Noviembre,11,11/1/2012,Indonesia,4,70,0,74
2012,Noviembre,11,11/1/2012,Iraq,0,1,0,1
2012,Noviembre,11,11/1/2012,Irán,6,7,0,13
2012,Noviembre,11,11/1/2012,República de Irlanda,61,186,0,247
2012,Noviembre,11,11/1/2012,Islandia,8,13,0,21
2012,Noviembre,11,11/1/2012,Isla de Man,75,219,0,294
2012,Noviembre,11,11/1/2012,Isla Johnston,0,2,0,2
2012,Noviembre,11,11/1/2012,Israel,47,381,0,428
2012,Noviembre,11,11/1/2012,Italia,556,2068,0,2624
2012,Noviembre,11,11/1/2012,Islas del Canal,1,4,0,5
2012,Noviembre,11,11/1/2012,Jamaica,17,18,0,35
2012,Noviembre,11,11/1/2012,Islas Midway/Territorio no incorporado de Estados Unidos,0,1,0,1
2012,Noviembre,11,11/1/2012,Japón,146,562,0,708
2012,Noviembre,11,11/1/2012,Jordania,1,7,0,8
2012,Noviembre,11,11/1/2012,Kazajistán,3,1,0,4
2012,Noviembre,11,11/1/2012,Kenia,5,8,0,13
2012,Noviembre,11,11/1/2012,Kirguistán,2,0,0,2
2012,Noviembre,11,11/1/2012,Kuwait,0,2,0,2
2012,Noviembre,11,11/1/2012,República de Kosovo,0,1,0,1
2012,Noviembre,11,11/1/2012,Letonia,8,25,0,33
2012,Noviembre,11,11/1/2012,Lituania,6,8,0,14
2012,Noviembre,11,11/1/2012,Líbano,21,35,0,56
2012,Noviembre,11,11/1/2012,Liberia,3,1,0,4
2012,Noviembre,11,11/1/2012,Libia,0,1,0,1
2012,Noviembre,11,11/1/2012,Liechtenstein,1,2,0,3
2012,Noviembre,11,11/1/2012,Luxemburgo,3,9,0,12
2012,Noviembre,11,11/1/2012,Macedonia,5,1,0,6
2012,Noviembre,11,11/1/2012,Madagascar,6,0,0,6
2012,Noviembre,11,11/1/2012,Malasia,13,20,0,33
2012,Noviembre,11,11/1/2012,Malawi,0,1,0,1
2012,Noviembre,11,11/1/2012,Malí,1,2,0,3
2012,Noviembre,11,11/1/2012,Malta,0,2,0,2
2012,Noviembre,11,11/1/2012,Marruecos,0,5,0,5
2012,Noviembre,11,11/1/2012,Mauricio,0,1,0,1
2012,Noviembre,11,11/1/2012,Mauritania,0,1,0,1
2012,Noviembre,11,11/1/2012,México,2223,5155,0,7378
2012,Noviembre,11,11/1/2012,República de Moldavia,0,1,0,1
2012,Noviembre,11,11/1/2012,Mónaco,0,2,0,2
2012,Noviembre,11,11/1/2012,Montenegro,0,1,0,1
2012,Noviembre,11,11/1/2012,Montserrat/Territorio Británico de Ultramar,1,1,0,2
2012,Noviembre,11,11/1/2012,Mozambique,1,1,0,2
2012,Noviembre,11,11/1/2012,Namibia,2,1,0,3
2012,Noviembre,11,11/1/2012,Nepal,1,3,0,4
2012,Noviembre,11,11/1/2012,Nicaragua,70,101,0,171
2012,Noviembre,11,11/1/2012,Nigeria,3,5,0,8
2012,Noviembre,11,11/1/2012,Níger,0,1,0,1
2012,Noviembre,11,11/1/2012,Noruega,79,145,0,224
2012,Noviembre,11,11/1/2012,Nueva Zelanda,49,94,0,143
2012,Noviembre,11,11/1/2012,Omán,0,1,0,1
2012,Noviembre,11,11/1/2012,Papúa Nueva Guinea,0,1,0,1
2012,Noviembre,11,11/1/2012,Pakistán,3,18,0,21
2012,Noviembre,11,11/1/2012,Panamá,1118,1763,0,2881
2012,Noviembre,11,11/1/2012,Paraguay,180,159,0,339
2012,Noviembre,11,11/1/2012,Perú,3265,4430,0,7695
2012,Noviembre,11,11/1/2012,Palestina,0,1,0,1
2012,Noviembre,11,11/1/2012,Polonia,127,148,0,275
2012,Noviembre,11,11/1/2012,Portugal,96,317,0,413
2012,Noviembre,11,11/1/2012,Polinesia Francesa/Colectividad de Ultramar Francesa,0,1,0,1
2012,Noviembre,11,11/1/2012,Puerto Rico/Territorio de Estados Unidos,4,2,0,6
2012,Noviembre,11,11/1/2012,Qatar,1,2,0,3
2012,Noviembre,11,11/1/2012,Reino Unido de Gran Bretaña e Irlanda del Norte,563,1389,0,1952
2012,Noviembre,11,11/1/2012,República CentroÁfricana,1,3,0,4
2012,Noviembre,11,11/1/2012,Federación de Rusia,155,215,0,370
2012,Noviembre,11,11/1/2012,República Dominicana,436,596,0,1032
2012,Noviembre,11,11/1/2012,Rumania,40,75,0,115
2012,Noviembre,11,11/1/2012,San Cristóbal y Nevis,2,2,0,4
2012,Noviembre,11,11/1/2012,San  Vicente y las Granadinas,0,2,0,2
2012,Noviembre,11,11/1/2012,Santa Lucia,4,5,0,9
2012,Noviembre,11,11/1/2012,Senegal,0,1,0,1
2012,Noviembre,11,11/1/2012,Serbia,2,7,0,9
2012,Noviembre,11,11/1/2012,Singapur,16,24,0,40
2012,Noviembre,11,11/1/2012,República Árabe Siria,0,6,0,6
2012,Noviembre,11,11/1/2012,Sri Lanka,1,2,0,3
2012,Noviembre,11,11/1/2012,Sudáfrica,27,110,0,137
2012,Noviembre,11,11/1/2012,Sudán,3,1,0,4
2012,Noviembre,11,11/1/2012,Suecia,195,309,0,504
2012,Noviembre,11,11/1/2012,Suiza,306,598,0,904
2012,Noviembre,11,11/1/2012,Surinam,25,33,0,58
2012,Noviembre,11,11/1/2012,Taiwán,37,75,0,112
2012,Noviembre,11,11/1/2012,Tailandia,8,5,0,13
2012,Noviembre,11,11/1/2012,Tíbet/Región Autónoma de China,0,1,0,1
2012,Noviembre,11,11/1/2012,Territorio Antártico Británico/Territorio Británico de Ultramar,0,6,0,6
2012,Noviembre,11,11/1/2012,Tanzania,1,1,0,2
2012,Noviembre,11,11/1/2012,Togo,0,1,0,1
2012,Noviembre,11,11/1/2012,Trinidad y Tobago,16,82,0,98
2012,Noviembre,11,11/1/2012,Túnez,1,2,0,3
2012,Noviembre,11,11/1/2012,Turquía,21,67,0,88
2012,Noviembre,11,11/1/2012,Ucrania,17,38,0,55
2012,Noviembre,11,11/1/2012,Uganda,3,1,0,4
2012,Noviembre,11,11/1/2012,Uruguay,273,452,0,725
2012,Noviembre,11,11/1/2012,Venezuela,7997,10855,0,18852
2012,Noviembre,11,11/1/2012,Vietnam,0,5,0,5
2012,Noviembre,11,11/1/2012,República Árabe de Yemen,0,3,0,3
2012,Noviembre,11,11/1/2012,Yugoslavia,2,1,0,3
2012,Noviembre,11,11/1/2012,Zambia,0,1,0,1
2012,Noviembre,11,11/1/2012,Zimbabue,1,6,0,7
2012,Noviembre,11,11/1/2012,Desconocido,1,3,0,4
2012,Diciembre,12,12/1/2012,Afganistán,0,1,0,1
2012,Diciembre,12,12/1/2012,Albania,2,4,0,6
2012,Diciembre,12,12/1/2012,Alemania,1680,2625,0,4305
2012,Diciembre,12,12/1/2012,Andorra,1,8,0,9
2012,Diciembre,12,12/1/2012,Angola,0,1,0,1
2012,Diciembre,12,12/1/2012,Antigua y Barbuda,0,1,0,1
2012,Diciembre,12,12/1/2012,Países Bajos,1048,1923,0,2971
2012,Diciembre,12,12/1/2012,Arabia Saudita,1,14,0,15
2012,Diciembre,12,12/1/2012,Argelia,3,2,0,5
2012,Diciembre,12,12/1/2012,Argentina,3756,4976,0,8732
2012,Diciembre,12,12/1/2012,República de Armenia,3,0,0,3
2012,Diciembre,12,12/1/2012,Aruba,4,4,0,8
2012,Diciembre,12,12/1/2012,Australia,530,865,0,1395
2012,Diciembre,12,12/1/2012,Austria,167,288,0,455
2012,Diciembre,12,12/1/2012,Azerbaiyán,1,2,0,3
2012,Diciembre,12,12/1/2012,Bahamas,4,11,0,15
2012,Diciembre,12,12/1/2012,Bangladesh,0,2,0,2
2012,Diciembre,12,12/1/2012,Barbados,3,4,0,7
2012,Diciembre,12,12/1/2012,República de Belarús,2,1,0,3
2012,Diciembre,12,12/1/2012,Bélgica,185,418,0,603
2012,Diciembre,12,12/1/2012,Belice,6,11,0,17
2012,Diciembre,12,12/1/2012,Bermudas/Territorio Británico de Ultramar,1,7,0,8
2012,Diciembre,12,12/1/2012,Bolivia,460,542,0,1002
2012,Diciembre,12,12/1/2012,Bosnia y Herzegovina,0,2,0,2
2012,Diciembre,12,12/1/2012,Brasil,2800,3527,0,6327
2012,Diciembre,12,12/1/2012,Bulgaria,11,15,0,26
2012,Diciembre,12,12/1/2012,Cabo Verde,1,0,0,1
2012,Diciembre,12,12/1/2012,Islas Caimán/Territorio Británico de Ultramar,14,26,0,40
2012,Diciembre,12,12/1/2012,Camboya,2,0,0,2
2012,Diciembre,12,12/1/2012,Camerún,1,2,0,3
2012,Diciembre,12,12/1/2012,Canadá,1978,3078,0,5056
2012,Diciembre,12,12/1/2012,España,2690,5609,0,8299
2012,Diciembre,12,12/1/2012,República Democrática del Congo,0,1,0,1
2012,Diciembre,12,12/1/2012,República de Corea,193,439,0,632
2012,Diciembre,12,12/1/2012,Costa de Marfil,1,1,0,2
2012,Diciembre,12,12/1/2012,Costa Rica,1253,1431,0,2684
2012,Diciembre,12,12/1/2012,Croacia,12,29,0,41
2012,Diciembre,12,12/1/2012,Cuba,141,245,0,386
2012,Diciembre,12,12/1/2012,Curazao,14,13,0,27
2012,Diciembre,12,12/1/2012,República Checa,41,50,0,91
2012,Diciembre,12,12/1/2012,Chile,2194,3528,0,5722
2012,Diciembre,12,12/1/2012,China,165,385,0,550
2012,Diciembre,12,12/1/2012,Chipre,1,7,0,8
2012,Diciembre,12,12/1/2012,Dinamarca,74,158,0,232
2012,Diciembre,12,12/1/2012,Dominica,5,2,0,7
2012,Diciembre,12,12/1/2012,Ecuador,4169,6083,0,10252
2012,Diciembre,12,12/1/2012,Egipto,8,23,0,31
2012,Diciembre,12,12/1/2012,El Salvador,362,611,0,973
2012,Diciembre,12,12/1/2012,Emiratos Árabes,0,7,0,7
2012,Diciembre,12,12/1/2012,Eritrea,0,1,0,1
2012,Diciembre,12,12/1/2012,Eslovaquia,12,23,0,35
2012,Diciembre,12,12/1/2012,Eslovenia,7,24,0,31
2012,Diciembre,12,12/1/2012,Estados Unidos de América,12853,22429,0,35282
2012,Diciembre,12,12/1/2012,Estonia,6,11,0,17
2012,Diciembre,12,12/1/2012,Etiopia,1,2,0,3
2012,Diciembre,12,12/1/2012,Filipinas,11,163,0,174
2012,Diciembre,12,12/1/2012,Finlandia,67,109,0,176
2012,Diciembre,12,12/1/2012,Francia,1287,2396,0,3683
2012,Diciembre,12,12/1/2012,Gabón,0,1,0,1
2012,Diciembre,12,12/1/2012,Gambia,0,1,0,1
2012,Diciembre,12,12/1/2012,Georgia,0,1,0,1
2012,Diciembre,12,12/1/2012,Ghana,1,6,0,7
2012,Diciembre,12,12/1/2012,Granada,0,1,0,1
2012,Diciembre,12,12/1/2012,Grecia,32,73,0,105
2012,Diciembre,12,12/1/2012,Guatemala,310,538,0,848
2012,Diciembre,12,12/1/2012,Guyana,6,12,0,18
2012,Diciembre,12,12/1/2012,Guinea Bissau,0,2,0,2
2012,Diciembre,12,12/1/2012,Haití,18,26,0,44
2012,Diciembre,12,12/1/2012,Honduras,165,263,0,428
2012,Diciembre,12,12/1/2012,Hungría,21,30,0,51
2012,Diciembre,12,12/1/2012,India,34,279,0,313
2012,Diciembre,12,12/1/2012,Indonesia,11,26,0,37
2012,Diciembre,12,12/1/2012,Irán,13,24,0,37
2012,Diciembre,12,12/1/2012,República de Irlanda,80,159,0,239
2012,Diciembre,12,12/1/2012,Islandia,10,15,0,25
2012,Diciembre,12,12/1/2012,Isla de Man,104,261,0,365
2012,Diciembre,12,12/1/2012,Isla Johnston,1,0,0,1
2012,Diciembre,12,12/1/2012,Israel,79,373,0,452
2012,Diciembre,12,12/1/2012,Islas Aland/Provincia de Finlandia,0,1,0,1
2012,Diciembre,12,12/1/2012,Italia,718,2127,0,2845
2012,Diciembre,12,12/1/2012,Islas del Canal,0,3,0,3
2012,Diciembre,12,12/1/2012,Jamaica,16,42,0,58
2012,Diciembre,12,12/1/2012,Japón,184,396,0,580
2012,Diciembre,12,12/1/2012,Jordania,5,6,0,11
2012,Diciembre,12,12/1/2012,Kazajistán,2,2,0,4
2012,Diciembre,12,12/1/2012,Kenia,2,7,0,9
2012,Diciembre,12,12/1/2012,Kirguistán,0,1,0,1
2012,Diciembre,12,12/1/2012,Kuwait,0,6,0,6
2012,Diciembre,12,12/1/2012,Letonia,10,15,0,25
2012,Diciembre,12,12/1/2012,Lituania,17,12,0,29
2012,Diciembre,12,12/1/2012,Líbano,17,35,0,52
2012,Diciembre,12,12/1/2012,Libia,0,7,0,7
2012,Diciembre,12,12/1/2012,Liechtenstein,4,6,0,10
2012,Diciembre,12,12/1/2012,Luxemburgo,5,13,0,18
2012,Diciembre,12,12/1/2012,Macedonia,1,0,0,1
2012,Diciembre,12,12/1/2012,Madagascar,0,1,0,1
2012,Diciembre,12,12/1/2012,Malasia,11,27,0,38
2012,Diciembre,12,12/1/2012,Malta,1,5,0,6
2012,Diciembre,12,12/1/2012,Marruecos,1,8,0,9
2012,Diciembre,12,12/1/2012,Mauricio,1,2,0,3
2012,Diciembre,12,12/1/2012,Mauritania,0,1,0,1
2012,Diciembre,12,12/1/2012,México,2651,4958,0,7609
2012,Diciembre,12,12/1/2012,República de Moldavia,1,1,0,2
2012,Diciembre,12,12/1/2012,Mónaco,3,0,0,3
2012,Diciembre,12,12/1/2012,Mongolia,1,0,0,1
2012,Diciembre,12,12/1/2012,Montenegro,0,1,0,1
2012,Diciembre,12,12/1/2012,Mozambique,1,4,0,5
2012,Diciembre,12,12/1/2012,Nepal,1,1,0,2
2012,Diciembre,12,12/1/2012,Nicaragua,68,84,0,152
2012,Diciembre,12,12/1/2012,Nigeria,2,10,0,12
2012,Diciembre,12,12/1/2012,Noruega,190,259,0,449
2012,Diciembre,12,12/1/2012,Nueva Zelanda,68,149,0,217
2012,Diciembre,12,12/1/2012,Omán,1,0,0,1
2012,Diciembre,12,12/1/2012,Pakistán,0,14,0,14
2012,Diciembre,12,12/1/2012,Panamá,1324,2095,0,3419
2012,Diciembre,12,12/1/2012,Paraguay,96,95,0,191
2012,Diciembre,12,12/1/2012,Perú,2733,3986,0,6719
2012,Diciembre,12,12/1/2012,Palestina,1,0,0,1
2012,Diciembre,12,12/1/2012,Polonia,98,131,0,229
2012,Diciembre,12,12/1/2012,Portugal,100,328,0,428
2012,Diciembre,12,12/1/2012,Qatar,0,5,0,5
2012,Diciembre,12,12/1/2012,Reino Unido de Gran Bretaña e Irlanda del Norte,780,1806,0,2586
2012,Diciembre,12,12/1/2012,República CentroÁfricana,1,0,0,1
2012,Diciembre,12,12/1/2012,Federación de Rusia,164,262,0,426
2012,Diciembre,12,12/1/2012,República Dominicana,298,556,0,854
2012,Diciembre,12,12/1/2012,Rumania,39,74,0,113
2012,Diciembre,12,12/1/2012,San Marino,0,3,0,3
2012,Diciembre,12,12/1/2012,San  Vicente y las Granadinas,1,1,0,2
2012,Diciembre,12,12/1/2012,Santa Lucia,6,4,0,10
2012,Diciembre,12,12/1/2012,Santa Sede/Ciudad del Vaticano,0,1,0,1
2012,Diciembre,12,12/1/2012,Senegal,0,4,0,4
2012,Diciembre,12,12/1/2012,Serbia,8,12,0,20
2012,Diciembre,12,12/1/2012,Singapur,6,16,0,22
2012,Diciembre,12,12/1/2012,República Árabe Siria,1,2,0,3
2012,Diciembre,12,12/1/2012,Sri Lanka,0,2,0,2
2012,Diciembre,12,12/1/2012,Sudáfrica,35,76,0,111
2012,Diciembre,12,12/1/2012,Suecia,364,583,0,947
2012,Diciembre,12,12/1/2012,Suiza,551,981,0,1532
2012,Diciembre,12,12/1/2012,Surinam,3,2,0,5
2012,Diciembre,12,12/1/2012,Taiwán,54,76,0,130
2012,Diciembre,12,12/1/2012,Tailandia,1,8,0,9
2012,Diciembre,12,12/1/2012,Tíbet/Región Autónoma de China,0,2,0,2
2012,Diciembre,12,12/1/2012,Territorio Antártico Británico/Territorio Británico de Ultramar,2,4,0,6
2012,Diciembre,12,12/1/2012,Tanzania,0,3,0,3
2012,Diciembre,12,12/1/2012,Trinidad y Tobago,54,78,0,132
2012,Diciembre,12,12/1/2012,Túnez,1,3,0,4
2012,Diciembre,12,12/1/2012,Turquía,34,104,0,138
2012,Diciembre,12,12/1/2012,Ucrania,24,35,0,59
2012,Diciembre,12,12/1/2012,Uruguay,208,421,0,629
2012,Diciembre,12,12/1/2012,Venezuela,14518,16682,0,31200
2012,Diciembre,12,12/1/2012,Vietnam,8,8,0,16
2012,Diciembre,12,12/1/2012,Zambia,0,1,0,1
2013,Enero,1,1/1/2013,Albania,1,1,0,2
2013,Enero,1,1/1/2013,Alemania,1512,2321,0,3833
2013,Enero,1,1/1/2013,Andorra,5,9,0,14
2013,Enero,1,1/1/2013,Angola,0,9,0,9
2013,Enero,1,1/1/2013,Antigua y Barbuda,2,1,0,3
2013,Enero,1,1/1/2013,Países Bajos,880,1418,0,2298
2013,Enero,1,1/1/2013,Arabia Saudita,1,12,0,13
2013,Enero,1,1/1/2013,Argelia,0,6,0,6
2013,Enero,1,1/1/2013,Argentina,7199,7403,0,14602
2013,Enero,1,1/1/2013,República de Armenia,1,1,0,2
2013,Enero,1,1/1/2013,Aruba,6,6,0,12
2013,Enero,1,1/1/2013,Australia,413,696,0,1109
2013,Enero,1,1/1/2013,Austria,141,317,0,458
2013,Enero,1,1/1/2013,Azerbaiyán,1,1,0,2
2013,Enero,1,1/1/2013,Bahamas,3,7,0,10
2013,Enero,1,1/1/2013,Bahréin,0,1,0,1
2013,Enero,1,1/1/2013,Bangladesh,2,5,0,7
2013,Enero,1,1/1/2013,Barbados,7,2,0,9
2013,Enero,1,1/1/2013,República de Belarús,5,8,0,13
2013,Enero,1,1/1/2013,Bélgica,144,384,0,528
2013,Enero,1,1/1/2013,Belice,3,8,0,11
2013,Enero,1,1/1/2013,Benín,0,1,0,1
2013,Enero,1,1/1/2013,Bolivia,519,637,0,1156
2013,Enero,1,1/1/2013,Bosnia y Herzegovina,1,2,0,3
2013,Enero,1,1/1/2013,Brasil,3325,4440,0,7765
2013,Enero,1,1/1/2013,Bulgaria,15,14,0,29
2013,Enero,1,1/1/2013,Burkina Faso,1,1,0,2
2013,Enero,1,1/1/2013,Islas Caimán/Territorio Británico de Ultramar,4,17,0,21
2013,Enero,1,1/1/2013,Camerún,0,6,0,6
2013,Enero,1,1/1/2013,Canadá,2088,2940,0,5028
2013,Enero,1,1/1/2013,España,2448,5751,0,8199
2013,Enero,1,1/1/2013,República Democrática del Congo,0,2,0,2
2013,Enero,1,1/1/2013,República de Corea,210,455,0,665
2013,Enero,1,1/1/2013,Costa de Marfil,1,0,0,1
2013,Enero,1,1/1/2013,Costa Rica,1090,1297,0,2387
2013,Enero,1,1/1/2013,Croacia,7,40,0,47
2013,Enero,1,1/1/2013,Cuba,157,255,0,412
2013,Enero,1,1/1/2013,Curazao,4,2,0,6
2013,Enero,1,1/1/2013,República Checa,53,92,0,145
2013,Enero,1,1/1/2013,Chile,2988,3984,0,6972
2013,Enero,1,1/1/2013,China,147,392,0,539
2013,Enero,1,1/1/2013,Chipre,1,4,0,5
2013,Enero,1,1/1/2013,Dinamarca,81,156,0,237
2013,Enero,1,1/1/2013,Dominica,4,5,0,9
2013,Enero,1,1/1/2013,Ecuador,3192,5194,0,8386
2013,Enero,1,1/1/2013,Egipto,6,22,0,28
2013,Enero,1,1/1/2013,El Salvador,474,699,0,1173
2013,Enero,1,1/1/2013,Emiratos Árabes,0,9,0,9
2013,Enero,1,1/1/2013,Eslovaquia,29,52,0,81
2013,Enero,1,1/1/2013,Eslovenia,24,35,0,59
2013,Enero,1,1/1/2013,Estados Unidos de América,7108,14701,0,21809
2013,Enero,1,1/1/2013,Estonia,15,18,0,33
2013,Enero,1,1/1/2013,Etiopia,2,1,0,3
2013,Enero,1,1/1/2013,Filipinas,23,101,0,124
2013,Enero,1,1/1/2013,Finlandia,68,98,0,166
2013,Enero,1,1/1/2013,Francia,1379,2306,0,3685
2013,Enero,1,1/1/2013,Gabón,1,1,0,2
2013,Enero,1,1/1/2013,Georgia,2,0,0,2
2013,Enero,1,1/1/2013,Ghana,0,3,0,3
2013,Enero,1,1/1/2013,Grecia,9,63,0,72
2013,Enero,1,1/1/2013,Guatemala,251,534,0,785
2013,Enero,1,1/1/2013,Guyana,7,18,0,25
2013,Enero,1,1/1/2013,Guinea Bissau,0,1,0,1
2013,Enero,1,1/1/2013,Guayana Francesa/Departamento de Ultramar Francés,0,1,0,1
2013,Enero,1,1/1/2013,Haití,3,20,0,23
2013,Enero,1,1/1/2013,Honduras,164,223,0,387
2013,Enero,1,1/1/2013,Hong Kong,0,2,0,2
2013,Enero,1,1/1/2013,Hungría,19,44,0,63
2013,Enero,1,1/1/2013,India,47,267,0,314
2013,Enero,1,1/1/2013,Indonesia,5,23,0,28
2013,Enero,1,1/1/2013,Irán,4,8,0,12
2013,Enero,1,1/1/2013,República de Irlanda,62,149,0,211
2013,Enero,1,1/1/2013,Islandia,2,7,0,9
2013,Enero,1,1/1/2013,Isla de Man,78,203,0,281
2013,Enero,1,1/1/2013,Isla Johnston,0,1,0,1
2013,Enero,1,1/1/2013,Israel,97,444,0,541
2013,Enero,1,1/1/2013,Islas Aland/Provincia de Finlandia,2,0,0,2
2013,Enero,1,1/1/2013,Italia,702,2390,0,3092
2013,Enero,1,1/1/2013,Jamaica,16,27,0,43
2013,Enero,1,1/1/2013,Islas Marianas del Norte,0,1,0,1
2013,Enero,1,1/1/2013,Japón,140,492,0,632
2013,Enero,1,1/1/2013,Jordania,0,2,0,2
2013,Enero,1,1/1/2013,Kenia,3,4,0,7
2013,Enero,1,1/1/2013,Kirguistán,3,1,0,4
2013,Enero,1,1/1/2013,Kuwait,0,1,0,1
2013,Enero,1,1/1/2013,Letonia,11,30,0,41
2013,Enero,1,1/1/2013,Lituania,17,16,0,33
2013,Enero,1,1/1/2013,Líbano,21,39,0,60
2013,Enero,1,1/1/2013,Liechtenstein,1,0,0,1
2013,Enero,1,1/1/2013,Luxemburgo,8,13,0,21
2013,Enero,1,1/1/2013,Macedonia,0,2,0,2
2013,Enero,1,1/1/2013,Malasia,10,12,0,22
2013,Enero,1,1/1/2013,Malawi,0,1,0,1
2013,Enero,1,1/1/2013,Malta,0,1,0,1
2013,Enero,1,1/1/2013,Marruecos,1,15,0,16
2013,Enero,1,1/1/2013,Mauricio,0,1,0,1
2013,Enero,1,1/1/2013,México,2027,4300,0,6327
2013,Enero,1,1/1/2013,República de Moldavia,2,0,0,2
2013,Enero,1,1/1/2013,Mónaco,0,2,0,2
2013,Enero,1,1/1/2013,Mongolia,2,0,0,2
2013,Enero,1,1/1/2013,Montenegro,2,0,0,2
2013,Enero,1,1/1/2013,Mozambique,0,4,0,4
2013,Enero,1,1/1/2013,Myanmar,0,2,0,2
2013,Enero,1,1/1/2013,Nepal,0,3,0,3
2013,Enero,1,1/1/2013,Nicaragua,89,79,0,168
2013,Enero,1,1/1/2013,Nigeria,3,12,0,15
2013,Enero,1,1/1/2013,Noruega,102,202,0,304
2013,Enero,1,1/1/2013,Nueva Zelanda,55,89,0,144
2013,Enero,1,1/1/2013,Pakistán,1,14,0,15
2013,Enero,1,1/1/2013,Panamá,1077,1632,0,2709
2013,Enero,1,1/1/2013,Paraguay,118,134,0,252
2013,Enero,1,1/1/2013,Perú,2878,4201,0,7079
2013,Enero,1,1/1/2013,Polonia,98,160,0,258
2013,Enero,1,1/1/2013,Portugal,133,475,0,608
2013,Enero,1,1/1/2013,Puerto Rico/Territorio de Estados Unidos,1,4,0,5
2013,Enero,1,1/1/2013,Qatar,2,22,0,24
2013,Enero,1,1/1/2013,Reino Unido de Gran Bretaña e Irlanda del Norte,656,1467,0,2123
2013,Enero,1,1/1/2013,Federación de Rusia,350,431,0,781
2013,Enero,1,1/1/2013,República Dominicana,291,440,0,731
2013,Enero,1,1/1/2013,Rumania,37,57,0,94
2013,Enero,1,1/1/2013,Rwanda,0,1,0,1
2013,Enero,1,1/1/2013,Samoa Occidental,1,0,0,1
2013,Enero,1,1/1/2013,San  Vicente y las Granadinas,0,2,0,2
2013,Enero,1,1/1/2013,Santa Lucia,10,4,0,14
2013,Enero,1,1/1/2013,Santa Sede/Ciudad del Vaticano,0,1,0,1
2013,Enero,1,1/1/2013,Senegal,0,1,0,1
2013,Enero,1,1/1/2013,Serbia,5,5,0,10
2013,Enero,1,1/1/2013,Sierra Leona,0,2,0,2
2013,Enero,1,1/1/2013,Singapur,16,26,0,42
2013,Enero,1,1/1/2013,República Árabe Siria,2,2,0,4
2013,Enero,1,1/1/2013,Sri Lanka,0,9,0,9
2013,Enero,1,1/1/2013,Sudáfrica,41,77,0,118
2013,Enero,1,1/1/2013,Suecia,229,410,0,639
2013,Enero,1,1/1/2013,Suiza,432,738,0,1170
2013,Enero,1,1/1/2013,Surinam,12,19,0,31
2013,Enero,1,1/1/2013,Taiwán,38,73,0,111
2013,Enero,1,1/1/2013,Tailandia,1,5,0,6
2013,Enero,1,1/1/2013,Tíbet/Región Autónoma de China,0,1,0,1
2013,Enero,1,1/1/2013,Territorio Antártico Británico/Territorio Británico de Ultramar,4,2,0,6
2013,Enero,1,1/1/2013,Tanzania,1,3,0,4
2013,Enero,1,1/1/2013,Togo,0,3,0,3
2013,Enero,1,1/1/2013,Trinidad y Tobago,28,72,0,100
2013,Enero,1,1/1/2013,Túnez,3,1,0,4
2013,Enero,1,1/1/2013,Turkmenistán,2,0,0,2
2013,Enero,1,1/1/2013,Turquía,62,146,0,208
2013,Enero,1,1/1/2013,Ucrania,38,45,0,83
2013,Enero,1,1/1/2013,Uganda,0,2,0,2
2013,Enero,1,1/1/2013,Uruguay,313,418,0,731
2013,Enero,1,1/1/2013,Uzbekistán,1,0,0,1
2013,Enero,1,1/1/2013,Venezuela,9778,11645,0,21423
2013,Enero,1,1/1/2013,Vietnam,1,1,0,2
2013,Enero,1,1/1/2013,Yugoslavia,1,0,0,1
2013,Enero,1,1/1/2013,Zambia,0,1,0,1
2013,Enero,1,1/1/2013,Zimbabue,0,2,0,2
2013,Enero,1,1/1/2013,Desconocido,1,0,0,1
2013,Febrero,2,2/1/2013,Afganistán,0,1,0,1
2013,Febrero,2,2/1/2013,Albania,3,0,0,3
2013,Febrero,2,2/1/2013,Alemania,1513,2454,0,3967
2013,Febrero,2,2/1/2013,Andorra,1,11,0,12
2013,Febrero,2,2/1/2013,Angola,0,2,0,2
2013,Febrero,2,2/1/2013,Antigua y Barbuda,0,3,0,3
2013,Febrero,2,2/1/2013,Países Bajos,930,1517,0,2447
2013,Febrero,2,2/1/2013,Arabia Saudita,0,4,0,4
2013,Febrero,2,2/1/2013,Argelia,1,2,0,3
2013,Febrero,2,2/1/2013,Argentina,5280,6493,0,11773
2013,Febrero,2,2/1/2013,República de Armenia,2,1,0,3
2013,Febrero,2,2/1/2013,Aruba,10,8,0,18
2013,Febrero,2,2/1/2013,Australia,293,594,0,887
2013,Febrero,2,2/1/2013,Austria,127,278,0,405
2013,Febrero,2,2/1/2013,Azerbaiyán,0,3,0,3
2013,Febrero,2,2/1/2013,Bahamas,5,13,0,18
2013,Febrero,2,2/1/2013,Bangladesh,0,20,0,20
2013,Febrero,2,2/1/2013,Barbados,2,3,0,5
2013,Febrero,2,2/1/2013,República de Belarús,5,1,0,6
2013,Febrero,2,2/1/2013,Bélgica,164,342,0,506
2013,Febrero,2,2/1/2013,Belice,5,12,0,17
2013,Febrero,2,2/1/2013,Benín,1,0,0,1
2013,Febrero,2,2/1/2013,Bermudas/Territorio Británico de Ultramar,2,1,0,3
2013,Febrero,2,2/1/2013,Bolivia,1068,862,0,1930
2013,Febrero,2,2/1/2013,Bosnia y Herzegovina,1,1,0,2
2013,Febrero,2,2/1/2013,Brasil,2793,3759,0,6552
2013,Febrero,2,2/1/2013,Bulgaria,13,7,0,20
2013,Febrero,2,2/1/2013,Burundi,0,1,0,1
2013,Febrero,2,2/1/2013,Islas Caimán/Territorio Británico de Ultramar,2,2,0,4
2013,Febrero,2,2/1/2013,Camerún,3,3,0,6
2013,Febrero,2,2/1/2013,Canadá,2055,2881,0,4936
2013,Febrero,2,2/1/2013,España,2041,5360,0,7401
2013,Febrero,2,2/1/2013,República Democrática del Congo,1,2,0,3
2013,Febrero,2,2/1/2013,República de Corea,126,419,0,545
2013,Febrero,2,2/1/2013,Costa de Marfil,0,3,0,3
2013,Febrero,2,2/1/2013,Costa Rica,956,1159,0,2115
2013,Febrero,2,2/1/2013,Croacia,19,27,0,46
2013,Febrero,2,2/1/2013,Cuba,128,237,0,365
2013,Febrero,2,2/1/2013,Curazao,14,13,0,27
2013,Febrero,2,2/1/2013,República Checa,47,83,0,130
2013,Febrero,2,2/1/2013,Chile,4852,5336,0,10188
2013,Febrero,2,2/1/2013,China,178,412,0,590
2013,Febrero,2,2/1/2013,Chipre,0,5,0,5
2013,Febrero,2,2/1/2013,Dinamarca,104,175,0,279
2013,Febrero,2,2/1/2013,Dominica,4,2,0,6
2013,Febrero,2,2/1/2013,Ecuador,4552,5534,0,10086
2013,Febrero,2,2/1/2013,Egipto,1,15,0,16
2013,Febrero,2,2/1/2013,El Salvador,626,857,0,1483
2013,Febrero,2,2/1/2013,Emiratos Árabes,1,7,0,8
2013,Febrero,2,2/1/2013,Eslovaquia,11,33,0,44
2013,Febrero,2,2/1/2013,Eslovenia,27,37,0,64
2013,Febrero,2,2/1/2013,Estados Unidos de América,8222,17433,0,25655
2013,Febrero,2,2/1/2013,Estonia,19,15,0,34
2013,Febrero,2,2/1/2013,Etiopia,2,6,0,8
2013,Febrero,2,2/1/2013,Islas Fiji,0,2,0,2
2013,Febrero,2,2/1/2013,Filipinas,23,98,0,121
2013,Febrero,2,2/1/2013,Finlandia,52,105,0,157
2013,Febrero,2,2/1/2013,Francia,1158,2130,0,3288
2013,Febrero,2,2/1/2013,Gabón,2,2,0,4
2013,Febrero,2,2/1/2013,Gambia,0,2,0,2
2013,Febrero,2,2/1/2013,Georgia,7,2,0,9
2013,Febrero,2,2/1/2013,Ghana,1,5,0,6
2013,Febrero,2,2/1/2013,Granada,1,0,0,1
2013,Febrero,2,2/1/2013,Grecia,30,73,0,103
2013,Febrero,2,2/1/2013,Guatemala,353,728,0,1081
2013,Febrero,2,2/1/2013,Guyana,10,5,0,15
2013,Febrero,2,2/1/2013,Guinea Ecuatorial,0,1,0,1
2013,Febrero,2,2/1/2013,Haití,17,18,0,35
2013,Febrero,2,2/1/2013,Honduras,228,288,0,516
2013,Febrero,2,2/1/2013,Hungría,29,49,0,78
2013,Febrero,2,2/1/2013,India,43,293,0,336
2013,Febrero,2,2/1/2013,Indonesia,11,22,0,33
2013,Febrero,2,2/1/2013,Irán,3,10,0,13
2013,Febrero,2,2/1/2013,República de Irlanda,54,131,0,185
2013,Febrero,2,2/1/2013,Islandia,3,4,0,7
2013,Febrero,2,2/1/2013,Isla de Man,79,172,0,251
2013,Febrero,2,2/1/2013,Israel,88,485,0,573
2013,Febrero,2,2/1/2013,Islas Aland/Provincia de Finlandia,1,0,0,1
2013,Febrero,2,2/1/2013,Italia,600,2037,0,2637
2013,Febrero,2,2/1/2013,Jamaica,20,29,0,49
2013,Febrero,2,2/1/2013,Islas Salomón,1,0,0,1
2013,Febrero,2,2/1/2013,Japón,185,498,0,683
2013,Febrero,2,2/1/2013,Jordania,4,7,0,11
2013,Febrero,2,2/1/2013,Kazajistán,4,3,0,7
2013,Febrero,2,2/1/2013,Kenia,4,10,0,14
2013,Febrero,2,2/1/2013,Kirguistán,1,0,0,1
2013,Febrero,2,2/1/2013,Kuwait,0,6,0,6
2013,Febrero,2,2/1/2013,República de Kosovo,0,1,0,1
2013,Febrero,2,2/1/2013,Letonia,9,17,0,26
2013,Febrero,2,2/1/2013,Lituania,11,32,0,43
2013,Febrero,2,2/1/2013,Líbano,18,25,0,43
2013,Febrero,2,2/1/2013,Liberia,2,1,0,3
2013,Febrero,2,2/1/2013,Libia,0,2,0,2
2013,Febrero,2,2/1/2013,Liechtenstein,2,0,0,2
2013,Febrero,2,2/1/2013,Luxemburgo,9,9,0,18
2013,Febrero,2,2/1/2013,Macedonia,0,1,0,1
2013,Febrero,2,2/1/2013,Madagascar,1,0,0,1
2013,Febrero,2,2/1/2013,Malasia,16,21,0,37
2013,Febrero,2,2/1/2013,Malawi,1,0,0,1
2013,Febrero,2,2/1/2013,Malta,4,4,0,8
2013,Febrero,2,2/1/2013,Marruecos,4,6,0,10
2013,Febrero,2,2/1/2013,Mauricio,0,2,0,2
2013,Febrero,2,2/1/2013,Mauritania,3,1,0,4
2013,Febrero,2,2/1/2013,México,1578,4430,0,6008
2013,Febrero,2,2/1/2013,República de Moldavia,1,4,0,5
2013,Febrero,2,2/1/2013,Mongolia,1,0,0,1
2013,Febrero,2,2/1/2013,Mozambique,0,1,0,1
2013,Febrero,2,2/1/2013,Nepal,0,4,0,4
2013,Febrero,2,2/1/2013,Nicaragua,68,79,0,147
2013,Febrero,2,2/1/2013,Nigeria,3,16,0,19
2013,Febrero,2,2/1/2013,Níger,0,1,0,1
2013,Febrero,2,2/1/2013,Noruega,80,152,0,232
2013,Febrero,2,2/1/2013,Nueva Zelanda,41,83,0,124
2013,Febrero,2,2/1/2013,Omán,0,2,0,2
2013,Febrero,2,2/1/2013,Pakistán,1,22,0,23
2013,Febrero,2,2/1/2013,Panamá,1178,1638,0,2816
2013,Febrero,2,2/1/2013,Paraguay,204,219,0,423
2013,Febrero,2,2/1/2013,Perú,5600,5514,0,11114
2013,Febrero,2,2/1/2013,Palestina,2,1,0,3
2013,Febrero,2,2/1/2013,Polonia,113,161,0,274
2013,Febrero,2,2/1/2013,Portugal,125,337,0,462
2013,Febrero,2,2/1/2013,Puerto Rico/Territorio de Estados Unidos,0,1,0,1
2013,Febrero,2,2/1/2013,Qatar,1,78,0,79
2013,Febrero,2,2/1/2013,Reino Unido de Gran Bretaña e Irlanda del Norte,664,1439,0,2103
2013,Febrero,2,2/1/2013,República CentroÁfricana,0,3,0,3
2013,Febrero,2,2/1/2013,Federación de Rusia,188,266,0,454
2013,Febrero,2,2/1/2013,República Dominicana,365,557,0,922
2013,Febrero,2,2/1/2013,República Democrática Popular de Corea,1,0,0,1
2013,Febrero,2,2/1/2013,Rumania,43,75,0,118
2013,Febrero,2,2/1/2013,San Cristóbal y Nevis,0,3,0,3
2013,Febrero,2,2/1/2013,San  Vicente y las Granadinas,1,2,0,3
2013,Febrero,2,2/1/2013,Santa Lucia,1,2,0,3
2013,Febrero,2,2/1/2013,Senegal,0,1,0,1
2013,Febrero,2,2/1/2013,Serbia,9,16,0,25
2013,Febrero,2,2/1/2013,Singapur,9,14,0,23
2013,Febrero,2,2/1/2013,República Árabe Siria,1,2,0,3
2013,Febrero,2,2/1/2013,Sri Lanka,0,5,0,5
2013,Febrero,2,2/1/2013,Sudáfrica,23,71,0,94
2013,Febrero,2,2/1/2013,Sudán,1,4,0,5
2013,Febrero,2,2/1/2013,Suecia,249,371,0,620
2013,Febrero,2,2/1/2013,Suiza,417,753,0,1170
2013,Febrero,2,2/1/2013,Surinam,11,22,0,33
2013,Febrero,2,2/1/2013,Suazilandia,1,0,0,1
2013,Febrero,2,2/1/2013,Taiwán,39,51,0,90
2013,Febrero,2,2/1/2013,República de Tayikistán,0,1,0,1
2013,Febrero,2,2/1/2013,Tailandia,16,14,0,30
2013,Febrero,2,2/1/2013,Tíbet/Región Autónoma de China,1,4,0,5
2013,Febrero,2,2/1/2013,Territorio Antártico Británico/Territorio Británico de Ultramar,5,4,0,9
2013,Febrero,2,2/1/2013,Tanzania,1,4,0,5
2013,Febrero,2,2/1/2013,Togo,0,2,0,2
2013,Febrero,2,2/1/2013,Trinidad y Tobago,24,52,0,76
2013,Febrero,2,2/1/2013,Túnez,0,4,0,4
2013,Febrero,2,2/1/2013,Turquía,23,71,0,94
2013,Febrero,2,2/1/2013,Ucrania,20,20,0,40
2013,Febrero,2,2/1/2013,Uganda,2,2,0,4
2013,Febrero,2,2/1/2013,Uruguay,379,515,0,894
2013,Febrero,2,2/1/2013,Venezuela,11282,12646,0,23928
2013,Febrero,2,2/1/2013,Vietnam,1,0,0,1
2013,Febrero,2,2/1/2013,República Árabe de Yemen,0,1,0,1
2013,Febrero,2,2/1/2013,Zambia,0,2,0,2
2013,Febrero,2,2/1/2013,Zimbabue,0,1,0,1
2013,Febrero,2,2/1/2013,Desconocido,31,69,0,100
2013,Marzo,3,3/1/2013,Albania,2,2,0,4
2013,Marzo,3,3/1/2013,Alemania,1679,2570,0,4249
2013,Marzo,3,3/1/2013,Andorra,2,9,0,11
2013,Marzo,3,3/1/2013,Angola,0,1,0,1
2013,Marzo,3,3/1/2013,Antigua y Barbuda,0,2,0,2
2013,Marzo,3,3/1/2013,Países Bajos,925,1527,0,2452
2013,Marzo,3,3/1/2013,Arabia Saudita,1,15,0,16
2013,Marzo,3,3/1/2013,Argelia,2,3,0,5
2013,Marzo,3,3/1/2013,Argentina,5615,6530,0,12145
2013,Marzo,3,3/1/2013,República de Armenia,0,1,0,1
2013,Marzo,3,3/1/2013,Aruba,2,0,0,2
2013,Marzo,3,3/1/2013,Australia,299,554,0,853
2013,Marzo,3,3/1/2013,Austria,126,277,0,403
2013,Marzo,3,3/1/2013,Azerbaiyán,1,0,0,1
2013,Marzo,3,3/1/2013,Bahamas,3,5,0,8
2013,Marzo,3,3/1/2013,Bangladesh,1,3,0,4
2013,Marzo,3,3/1/2013,Barbados,6,10,0,16
2013,Marzo,3,3/1/2013,República de Belarús,1,6,0,7
2013,Marzo,3,3/1/2013,Bélgica,139,321,0,460
2013,Marzo,3,3/1/2013,Belice,4,14,0,18
2013,Marzo,3,3/1/2013,Bermudas/Territorio Británico de Ultramar,3,1,0,4
2013,Marzo,3,3/1/2013,Bolivia,288,533,0,821
2013,Marzo,3,3/1/2013,Bosnia y Herzegovina,1,1,0,2
2013,Marzo,3,3/1/2013,Brasil,2158,3538,0,5696
2013,Marzo,3,3/1/2013,Bulgaria,8,9,0,17
2013,Marzo,3,3/1/2013,Bután,0,1,0,1
2013,Marzo,3,3/1/2013,Islas Caimán/Territorio Británico de Ultramar,1,18,0,19
2013,Marzo,3,3/1/2013,Camboya,0,1,0,1
2013,Marzo,3,3/1/2013,Camerún,0,1,0,1
2013,Marzo,3,3/1/2013,Canadá,1835,2552,0,4387
2013,Marzo,3,3/1/2013,España,2332,5362,0,7694
2013,Marzo,3,3/1/2013,República Democrática del Congo,0,1,0,1
2013,Marzo,3,3/1/2013,República de Corea,155,524,0,679
2013,Marzo,3,3/1/2013,Costa Rica,920,1272,0,2192
2013,Marzo,3,3/1/2013,Croacia,8,32,0,40
2013,Marzo,3,3/1/2013,Cuba,121,199,0,320
2013,Marzo,3,3/1/2013,Curazao,10,12,0,22
2013,Marzo,3,3/1/2013,República Checa,40,45,0,85
2013,Marzo,3,3/1/2013,Chile,2519,3732,0,6251
2013,Marzo,3,3/1/2013,China,186,545,0,731
2013,Marzo,3,3/1/2013,Chipre,1,2,0,3
2013,Marzo,3,3/1/2013,Dinamarca,85,181,0,266
2013,Marzo,3,3/1/2013,Dominica,1,2,0,3
2013,Marzo,3,3/1/2013,Ecuador,3456,5041,0,8497
2013,Marzo,3,3/1/2013,Egipto,1,32,0,33
2013,Marzo,3,3/1/2013,El Salvador,490,787,0,1277
2013,Marzo,3,3/1/2013,Emiratos Árabes,1,0,0,1
2013,Marzo,3,3/1/2013,Eslovaquia,20,37,0,57
2013,Marzo,3,3/1/2013,Eslovenia,12,38,0,50
2013,Marzo,3,3/1/2013,Estados Unidos de América,9525,17368,0,26893
2013,Marzo,3,3/1/2013,Estonia,14,13,0,27
2013,Marzo,3,3/1/2013,Etiopia,2,3,0,5
2013,Marzo,3,3/1/2013,Islas Fiji,2,2,0,4
2013,Marzo,3,3/1/2013,Filipinas,31,164,0,195
2013,Marzo,3,3/1/2013,Finlandia,47,75,0,122
2013,Marzo,3,3/1/2013,Francia,1104,2079,0,3183
2013,Marzo,3,3/1/2013,Gabón,1,1,0,2
2013,Marzo,3,3/1/2013,Georgia,5,3,0,8
2013,Marzo,3,3/1/2013,Ghana,2,4,0,6
2013,Marzo,3,3/1/2013,Grecia,27,67,0,94
2013,Marzo,3,3/1/2013,Guatemala,268,627,0,895
2013,Marzo,3,3/1/2013,Guyana,10,22,0,32
2013,Marzo,3,3/1/2013,Guinea,0,1,0,1
2013,Marzo,3,3/1/2013,Guayana Francesa/Departamento de Ultramar Francés,0,1,0,1
2013,Marzo,3,3/1/2013,Haití,5,16,0,21
2013,Marzo,3,3/1/2013,Honduras,180,239,0,419
2013,Marzo,3,3/1/2013,Hungría,46,92,0,138
2013,Marzo,3,3/1/2013,India,40,298,0,338
2013,Marzo,3,3/1/2013,Indonesia,10,19,0,29
2013,Marzo,3,3/1/2013,Iraq,0,2,0,2
2013,Marzo,3,3/1/2013,Irán,4,37,0,41
2013,Marzo,3,3/1/2013,República de Irlanda,64,150,0,214
2013,Marzo,3,3/1/2013,Islandia,1,0,0,1
2013,Marzo,3,3/1/2013,Isla de Man,78,201,0,279
2013,Marzo,3,3/1/2013,Isla Johnston,0,2,0,2
2013,Marzo,3,3/1/2013,Israel,95,482,0,577
2013,Marzo,3,3/1/2013,Islas Aland/Provincia de Finlandia,1,4,0,5
2013,Marzo,3,3/1/2013,Italia,515,1676,0,2191
2013,Marzo,3,3/1/2013,Jamaica,23,41,0,64
2013,Marzo,3,3/1/2013,Islas Salomón,1,0,0,1
2013,Marzo,3,3/1/2013,Japón,176,536,0,712
2013,Marzo,3,3/1/2013,Jordania,1,2,0,3
2013,Marzo,3,3/1/2013,Kazajistán,2,8,0,10
2013,Marzo,3,3/1/2013,Kenia,4,7,0,11
2013,Marzo,3,3/1/2013,Lesoto,0,2,0,2
2013,Marzo,3,3/1/2013,Letonia,4,8,0,12
2013,Marzo,3,3/1/2013,Lituania,20,17,0,37
2013,Marzo,3,3/1/2013,Líbano,13,34,0,47
2013,Marzo,3,3/1/2013,Liechtenstein,0,1,0,1
2013,Marzo,3,3/1/2013,Luxemburgo,11,17,0,28
2013,Marzo,3,3/1/2013,Macedonia,0,1,0,1
2013,Marzo,3,3/1/2013,Malasia,15,28,0,43
2013,Marzo,3,3/1/2013,Malí,1,2,0,3
2013,Marzo,3,3/1/2013,Malta,1,6,0,7
2013,Marzo,3,3/1/2013,Marruecos,4,9,0,13
2013,Marzo,3,3/1/2013,Mauricio,0,1,0,1
2013,Marzo,3,3/1/2013,México,2152,4729,0,6881
2013,Marzo,3,3/1/2013,República de Moldavia,1,0,0,1
2013,Marzo,3,3/1/2013,Mónaco,0,1,0,1
2013,Marzo,3,3/1/2013,Mongolia,2,8,0,10
2013,Marzo,3,3/1/2013,Montenegro,0,1,0,1
2013,Marzo,3,3/1/2013,Myanmar,1,1,0,2
2013,Marzo,3,3/1/2013,Namibia,0,1,0,1
2013,Marzo,3,3/1/2013,Nepal,1,1,0,2
2013,Marzo,3,3/1/2013,Nicaragua,61,74,0,135
2013,Marzo,3,3/1/2013,Nigeria,5,9,0,14
2013,Marzo,3,3/1/2013,Noruega,130,178,0,308
2013,Marzo,3,3/1/2013,Nueva Zelanda,67,129,0,196
2013,Marzo,3,3/1/2013,Pakistán,3,12,0,15
2013,Marzo,3,3/1/2013,Panamá,862,1461,0,2323
2013,Marzo,3,3/1/2013,Paraguay,86,123,0,209
2013,Marzo,3,3/1/2013,Perú,3155,4350,0,7505
2013,Marzo,3,3/1/2013,Palestina,2,3,0,5
2013,Marzo,3,3/1/2013,Polonia,86,124,0,210
2013,Marzo,3,3/1/2013,Portugal,152,393,0,545
2013,Marzo,3,3/1/2013,Puerto Rico/Territorio de Estados Unidos,5,1,0,6
2013,Marzo,3,3/1/2013,Reino Unido de Gran Bretaña e Irlanda del Norte,682,1571,0,2253
2013,Marzo,3,3/1/2013,Federación de Rusia,154,214,0,368
2013,Marzo,3,3/1/2013,República Dominicana,300,508,0,808
2013,Marzo,3,3/1/2013,Rumania,37,73,0,110
2013,Marzo,3,3/1/2013,San Cristóbal y Nevis,0,2,0,2
2013,Marzo,3,3/1/2013,San Marino,1,3,0,4
2013,Marzo,3,3/1/2013,San  Vicente y las Granadinas,2,2,0,4
2013,Marzo,3,3/1/2013,Santa Lucia,4,2,0,6
2013,Marzo,3,3/1/2013,Santa Sede/Ciudad del Vaticano,0,1,0,1
2013,Marzo,3,3/1/2013,Senegal,0,1,0,1
2013,Marzo,3,3/1/2013,Serbia,7,9,0,16
2013,Marzo,3,3/1/2013,Singapur,12,14,0,26
2013,Marzo,3,3/1/2013,República Árabe Siria,0,2,0,2
2013,Marzo,3,3/1/2013,Sri Lanka,2,1,0,3
2013,Marzo,3,3/1/2013,Sudáfrica,49,86,0,135
2013,Marzo,3,3/1/2013,Suecia,165,283,0,448
2013,Marzo,3,3/1/2013,Suiza,393,650,0,1043
2013,Marzo,3,3/1/2013,Surinam,6,25,0,31
2013,Marzo,3,3/1/2013,Taiwán,91,136,0,227
2013,Marzo,3,3/1/2013,Tailandia,4,4,0,8
2013,Marzo,3,3/1/2013,Tíbet/Región Autónoma de China,0,2,0,2
2013,Marzo,3,3/1/2013,Territorio Antártico Británico/Territorio Británico de Ultramar,5,3,0,8
2013,Marzo,3,3/1/2013,Tanzania,1,1,0,2
2013,Marzo,3,3/1/2013,Trinidad y Tobago,23,65,0,88
2013,Marzo,3,3/1/2013,Túnez,1,2,0,3
2013,Marzo,3,3/1/2013,Turquía,21,68,0,89
2013,Marzo,3,3/1/2013,Ucrania,19,23,0,42
2013,Marzo,3,3/1/2013,Uganda,0,3,0,3
2013,Marzo,3,3/1/2013,Uruguay,300,489,0,789
2013,Marzo,3,3/1/2013,Uzbekistán,1,0,0,1
2013,Marzo,3,3/1/2013,Venezuela,9081,10847,0,19928
2013,Marzo,3,3/1/2013,Vietnam,2,6,0,8
2013,Marzo,3,3/1/2013,Zambia,0,1,0,1
2013,Marzo,3,3/1/2013,Zimbabue,2,4,0,6
2013,Marzo,3,3/1/2013,Desconocido,0,2,0,2
2013,Abril,4,4/1/2013,Albania,6,2,0,8
2013,Abril,4,4/1/2013,Alemania,1127,1941,0,3068
2013,Abril,4,4/1/2013,Andorra,2,12,0,14
2013,Abril,4,4/1/2013,Antigua y Barbuda,0,1,0,1
2013,Abril,4,4/1/2013,Países Bajos,986,1647,0,2633
2013,Abril,4,4/1/2013,Arabia Saudita,0,6,0,6
2013,Abril,4,4/1/2013,Argelia,1,3,0,4
2013,Abril,4,4/1/2013,Argentina,4915,6126,0,11041
2013,Abril,4,4/1/2013,República de Armenia,0,1,0,1
2013,Abril,4,4/1/2013,Aruba,4,11,0,15
2013,Abril,4,4/1/2013,Australia,264,514,0,778
2013,Abril,4,4/1/2013,Austria,76,209,0,285
2013,Abril,4,4/1/2013,Azerbaiyán,3,3,0,6
2013,Abril,4,4/1/2013,Bahamas,3,12,0,15
2013,Abril,4,4/1/2013,Bangladesh,2,4,0,6
2013,Abril,4,4/1/2013,Barbados,3,8,0,11
2013,Abril,4,4/1/2013,República de Belarús,7,4,0,11
2013,Abril,4,4/1/2013,Bélgica,106,353,0,459
2013,Abril,4,4/1/2013,Belice,2,16,0,18
2013,Abril,4,4/1/2013,Bermudas/Territorio Británico de Ultramar,0,3,0,3
2013,Abril,4,4/1/2013,Bolivia,357,561,0,918
2013,Abril,4,4/1/2013,Botsuana,0,3,0,3
2013,Abril,4,4/1/2013,Brasil,2327,4191,0,6518
2013,Abril,4,4/1/2013,Bulgaria,19,12,0,31
2013,Abril,4,4/1/2013,Bután,0,1,0,1
2013,Abril,4,4/1/2013,Islas Caimán/Territorio Británico de Ultramar,6,7,0,13
2013,Abril,4,4/1/2013,Camerún,2,3,0,5
2013,Abril,4,4/1/2013,Canadá,806,1642,0,2448
2013,Abril,4,4/1/2013,Chad,0,2,0,2
2013,Abril,4,4/1/2013,España,1976,5648,0,7624
2013,Abril,4,4/1/2013,República Democrática del Congo,0,4,0,4
2013,Abril,4,4/1/2013,República de Corea,122,387,0,509
2013,Abril,4,4/1/2013,Costa de Marfil,0,1,0,1
2013,Abril,4,4/1/2013,Costa Rica,912,1324,0,2236
2013,Abril,4,4/1/2013,Croacia,4,27,0,31
2013,Abril,4,4/1/2013,Cuba,104,226,0,330
2013,Abril,4,4/1/2013,Curazao,6,10,0,16
2013,Abril,4,4/1/2013,República Checa,29,46,0,75
2013,Abril,4,4/1/2013,Chile,2704,4067,0,6771
2013,Abril,4,4/1/2013,China,207,665,0,872
2013,Abril,4,4/1/2013,Chipre,0,6,0,6
2013,Abril,4,4/1/2013,Dinamarca,65,127,0,192
2013,Abril,4,4/1/2013,Dominica,0,10,0,10
2013,Abril,4,4/1/2013,Ecuador,4201,5968,0,10169
2013,Abril,4,4/1/2013,Egipto,4,26,0,30
2013,Abril,4,4/1/2013,El Salvador,624,885,0,1509
2013,Abril,4,4/1/2013,Emiratos Árabes,0,4,0,4
2013,Abril,4,4/1/2013,Eslovaquia,14,16,0,30
2013,Abril,4,4/1/2013,Eslovenia,14,36,0,50
2013,Abril,4,4/1/2013,Estados Unidos de América,7376,16213,0,23589
2013,Abril,4,4/1/2013,Estonia,3,6,0,9
2013,Abril,4,4/1/2013,Etiopia,2,5,0,7
2013,Abril,4,4/1/2013,Filipinas,25,103,0,128
2013,Abril,4,4/1/2013,Finlandia,41,102,0,143
2013,Abril,4,4/1/2013,Francia,925,1875,0,2800
2013,Abril,4,4/1/2013,Gabón,0,2,0,2
2013,Abril,4,4/1/2013,Gambia,1,0,0,1
2013,Abril,4,4/1/2013,Georgia,2,1,0,3
2013,Abril,4,4/1/2013,Ghana,1,1,0,2
2013,Abril,4,4/1/2013,Granada,1,0,0,1
2013,Abril,4,4/1/2013,Grecia,18,61,0,79
2013,Abril,4,4/1/2013,Guatemala,255,657,0,912
2013,Abril,4,4/1/2013,Guyana,3,20,0,23
2013,Abril,4,4/1/2013,Guinea Ecuatorial,1,0,0,1
2013,Abril,4,4/1/2013,Haití,6,14,0,20
2013,Abril,4,4/1/2013,Honduras,167,287,0,454
2013,Abril,4,4/1/2013,Hungría,20,42,0,62
2013,Abril,4,4/1/2013,India,38,300,0,338
2013,Abril,4,4/1/2013,Indonesia,16,23,0,39
2013,Abril,4,4/1/2013,Iraq,0,18,0,18
2013,Abril,4,4/1/2013,Irán,1,10,0,11
2013,Abril,4,4/1/2013,República de Irlanda,90,132,0,222
2013,Abril,4,4/1/2013,Islandia,6,10,0,16
2013,Abril,4,4/1/2013,Isla de Man,110,186,0,296
2013,Abril,4,4/1/2013,Israel,152,750,0,902
2013,Abril,4,4/1/2013,Italia,442,1807,0,2249
2013,Abril,4,4/1/2013,Islas del Canal,1,0,0,1
2013,Abril,4,4/1/2013,Jamaica,13,29,0,42
2013,Abril,4,4/1/2013,Japón,124,525,0,649
2013,Abril,4,4/1/2013,Jordania,3,3,0,6
2013,Abril,4,4/1/2013,Kenia,2,6,0,8
2013,Abril,4,4/1/2013,Kuwait,0,1,0,1
2013,Abril,4,4/1/2013,Lesoto,1,2,0,3
2013,Abril,4,4/1/2013,Letonia,12,15,0,27
2013,Abril,4,4/1/2013,Lituania,18,14,0,32
2013,Abril,4,4/1/2013,Líbano,17,32,0,49
2013,Abril,4,4/1/2013,Liberia,0,1,0,1
2013,Abril,4,4/1/2013,Libia,1,0,0,1
2013,Abril,4,4/1/2013,Luxemburgo,5,15,0,20
2013,Abril,4,4/1/2013,Macedonia,1,2,0,3
2013,Abril,4,4/1/2013,Madagascar,2,1,0,3
2013,Abril,4,4/1/2013,Malasia,10,35,0,45
2013,Abril,4,4/1/2013,Malta,1,5,0,6
2013,Abril,4,4/1/2013,Marruecos,2,16,0,18
2013,Abril,4,4/1/2013,Mauricio,0,1,0,1
2013,Abril,4,4/1/2013,Mauritania,0,1,0,1
2013,Abril,4,4/1/2013,México,1909,4847,0,6756
2013,Abril,4,4/1/2013,República de Moldavia,1,1,0,2
2013,Abril,4,4/1/2013,Montenegro,1,1,0,2
2013,Abril,4,4/1/2013,Mozambique,2,4,0,6
2013,Abril,4,4/1/2013,Myanmar,0,2,0,2
2013,Abril,4,4/1/2013,Namibia,1,1,0,2
2013,Abril,4,4/1/2013,Nepal,0,1,0,1
2013,Abril,4,4/1/2013,Nicaragua,53,85,0,138
2013,Abril,4,4/1/2013,Nigeria,2,11,0,13
2013,Abril,4,4/1/2013,Noruega,78,147,0,225
2013,Abril,4,4/1/2013,Nueva Zelanda,63,82,0,145
2013,Abril,4,4/1/2013,Pakistán,1,7,0,8
2013,Abril,4,4/1/2013,Palau,0,1,0,1
2013,Abril,4,4/1/2013,Panamá,1024,1617,0,2641
2013,Abril,4,4/1/2013,Paraguay,131,173,0,304
2013,Abril,4,4/1/2013,Perú,3511,5008,0,8519
2013,Abril,4,4/1/2013,Palestina,4,3,0,7
2013,Abril,4,4/1/2013,Polonia,71,146,0,217
2013,Abril,4,4/1/2013,Portugal,142,460,0,602
2013,Abril,4,4/1/2013,Puerto Rico/Territorio de Estados Unidos,0,2,0,2
2013,Abril,4,4/1/2013,Qatar,0,2,0,2
2013,Abril,4,4/1/2013,Reino Unido de Gran Bretaña e Irlanda del Norte,577,1387,0,1964
2013,Abril,4,4/1/2013,República CentroÁfricana,0,2,0,2
2013,Abril,4,4/1/2013,Federación de Rusia,159,272,0,431
2013,Abril,4,4/1/2013,República Dominicana,308,507,0,815
2013,Abril,4,4/1/2013,Rumania,27,82,0,109
2013,Abril,4,4/1/2013,San Cristóbal y Nevis,0,1,0,1
2013,Abril,4,4/1/2013,San  Vicente y las Granadinas,1,2,0,3
2013,Abril,4,4/1/2013,Santa Lucia,3,3,0,6
2013,Abril,4,4/1/2013,Senegal,0,2,0,2
2013,Abril,4,4/1/2013,Serbia,5,6,0,11
2013,Abril,4,4/1/2013,Singapur,8,13,0,21
2013,Abril,4,4/1/2013,República Árabe Siria,0,1,0,1
2013,Abril,4,4/1/2013,Sri Lanka,2,1,0,3
2013,Abril,4,4/1/2013,Sudáfrica,53,162,0,215
2013,Abril,4,4/1/2013,Suecia,147,241,0,388
2013,Abril,4,4/1/2013,Suiza,312,545,0,857
2013,Abril,4,4/1/2013,Surinam,17,34,0,51
2013,Abril,4,4/1/2013,Suazilandia,1,0,0,1
2013,Abril,4,4/1/2013,Taiwán,45,81,0,126
2013,Abril,4,4/1/2013,Tailandia,4,10,0,14
2013,Abril,4,4/1/2013,Tíbet/Región Autónoma de China,1,4,0,5
2013,Abril,4,4/1/2013,Territorio Antártico Británico/Territorio Británico de Ultramar,0,9,0,9
2013,Abril,4,4/1/2013,Tanzania,0,2,0,2
2013,Abril,4,4/1/2013,Trinidad y Tobago,17,75,0,92
2013,Abril,4,4/1/2013,Túnez,1,3,0,4
2013,Abril,4,4/1/2013,Turquía,32,83,0,115
2013,Abril,4,4/1/2013,Ucrania,20,29,0,49
2013,Abril,4,4/1/2013,Uganda,0,3,0,3
2013,Abril,4,4/1/2013,Uruguay,313,482,0,795
2013,Abril,4,4/1/2013,Venezuela,7131,9698,0,16829
2013,Abril,4,4/1/2013,Vietnam,2,3,0,5
2013,Abril,4,4/1/2013,Islas Vírgenes Británicas/Territorio Británico de Ultramar,0,1,0,1
2013,Abril,4,4/1/2013,República Árabe de Yemen,1,1,0,2
2013,Abril,4,4/1/2013,Yugoslavia,1,0,0,1
2013,Abril,4,4/1/2013,Zambia,4,3,0,7
2013,Abril,4,4/1/2013,Zimbabue,0,5,0,5
2013,Abril,4,4/1/2013,Desconocido,1,0,0,1
2013,Mayo,5,5/1/2013,Albania,1,1,0,2
2013,Mayo,5,5/1/2013,Alemania,1163,1906,0,3069
2013,Mayo,5,5/1/2013,Andorra,2,12,0,14
2013,Mayo,5,5/1/2013,Angola,1,2,0,3
2013,Mayo,5,5/1/2013,Antigua y Barbuda,0,2,0,2
2013,Mayo,5,5/1/2013,Países Bajos,829,1471,0,2300
2013,Mayo,5,5/1/2013,Arabia Saudita,1,6,0,7
2013,Mayo,5,5/1/2013,Argelia,0,2,0,2
2013,Mayo,5,5/1/2013,Argentina,4153,5667,0,9820
2013,Mayo,5,5/1/2013,República de Armenia,0,2,0,2
2013,Mayo,5,5/1/2013,Aruba,4,2,0,6
2013,Mayo,5,5/1/2013,Australia,289,520,0,809
2013,Mayo,5,5/1/2013,Austria,68,173,0,241
2013,Mayo,5,5/1/2013,Azerbaiyán,0,3,0,3
2013,Mayo,5,5/1/2013,Bahamas,9,20,0,29
2013,Mayo,5,5/1/2013,Bahréin,1,0,0,1
2013,Mayo,5,5/1/2013,Bangladesh,1,5,0,6
2013,Mayo,5,5/1/2013,Barbados,2,4,0,6
2013,Mayo,5,5/1/2013,República de Belarús,2,7,0,9
2013,Mayo,5,5/1/2013,Bélgica,95,334,0,429
2013,Mayo,5,5/1/2013,Belice,7,16,0,23
2013,Mayo,5,5/1/2013,Benín,0,1,0,1
2013,Mayo,5,5/1/2013,Bermudas/Territorio Británico de Ultramar,0,2,0,2
2013,Mayo,5,5/1/2013,Bolivia,317,544,0,861
2013,Mayo,5,5/1/2013,Bosnia y Herzegovina,1,1,0,2
2013,Mayo,5,5/1/2013,Botsuana,1,1,0,2
2013,Mayo,5,5/1/2013,Brasil,2979,4690,0,7669
2013,Mayo,5,5/1/2013,Bulgaria,8,9,0,17
2013,Mayo,5,5/1/2013,Burundi,0,1,0,1
2013,Mayo,5,5/1/2013,Bután,1,1,0,2
2013,Mayo,5,5/1/2013,Cabo Verde,0,1,0,1
2013,Mayo,5,5/1/2013,Islas Caimán/Territorio Británico de Ultramar,2,1,0,3
2013,Mayo,5,5/1/2013,Camerún,1,0,0,1
2013,Mayo,5,5/1/2013,Canadá,828,1751,0,2579
2013,Mayo,5,5/1/2013,España,2067,5680,0,7747
2013,Mayo,5,5/1/2013,República Democrática del Congo,2,2,0,4
2013,Mayo,5,5/1/2013,República de Corea,146,496,0,642
2013,Mayo,5,5/1/2013,Costa de Marfil,0,1,0,1
2013,Mayo,5,5/1/2013,Costa Rica,805,1312,0,2117
2013,Mayo,5,5/1/2013,Croacia,2,24,0,26
2013,Mayo,5,5/1/2013,Cuba,123,226,0,349
2013,Mayo,5,5/1/2013,Curazao,6,6,0,12
2013,Mayo,5,5/1/2013,República Checa,24,39,0,63
2013,Mayo,5,5/1/2013,Chile,3196,4380,0,7576
2013,Mayo,5,5/1/2013,China,175,606,0,781
2013,Mayo,5,5/1/2013,Chipre,0,3,0,3
2013,Mayo,5,5/1/2013,Dinamarca,70,114,0,184
2013,Mayo,5,5/1/2013,Dominica,1,4,0,5
2013,Mayo,5,5/1/2013,Ecuador,3846,5775,0,9621
2013,Mayo,5,5/1/2013,Egipto,5,17,0,22
2013,Mayo,5,5/1/2013,El Salvador,487,803,0,1290
2013,Mayo,5,5/1/2013,Emiratos Árabes,4,2,0,6
2013,Mayo,5,5/1/2013,Eslovaquia,17,11,0,28
2013,Mayo,5,5/1/2013,Eslovenia,10,24,0,34
2013,Mayo,5,5/1/2013,Estados Unidos de América,9229,18287,0,27516
2013,Mayo,5,5/1/2013,Estonia,12,8,0,20
2013,Mayo,5,5/1/2013,Etiopia,1,4,0,5
2013,Mayo,5,5/1/2013,Filipinas,16,151,0,167
2013,Mayo,5,5/1/2013,Finlandia,50,108,0,158
2013,Mayo,5,5/1/2013,Francia,878,1868,0,2746
2013,Mayo,5,5/1/2013,Georgia,2,0,0,2
2013,Mayo,5,5/1/2013,Ghana,1,3,0,4
2013,Mayo,5,5/1/2013,Granada,0,2,0,2
2013,Mayo,5,5/1/2013,Grecia,20,66,0,86
2013,Mayo,5,5/1/2013,Guatemala,271,700,0,971
2013,Mayo,5,5/1/2013,Guyana,6,15,0,21
2013,Mayo,5,5/1/2013,Haití,5,28,0,33
2013,Mayo,5,5/1/2013,Honduras,150,278,0,428
2013,Mayo,5,5/1/2013,Hungría,19,22,0,41
2013,Mayo,5,5/1/2013,India,43,309,0,352
2013,Mayo,5,5/1/2013,Indonesia,14,30,0,44
2013,Mayo,5,5/1/2013,Iraq,1,1,0,2
2013,Mayo,5,5/1/2013,Irán,1,10,0,11
2013,Mayo,5,5/1/2013,República de Irlanda,60,138,0,198
2013,Mayo,5,5/1/2013,Islandia,10,10,0,20
2013,Mayo,5,5/1/2013,Isla de Man,76,168,0,244
2013,Mayo,5,5/1/2013,Israel,157,736,0,893
2013,Mayo,5,5/1/2013,Islas Aland/Provincia de Finlandia,0,2,0,2
2013,Mayo,5,5/1/2013,Italia,438,1709,0,2147
2013,Mayo,5,5/1/2013,Islas del Canal,1,5,0,6
2013,Mayo,5,5/1/2013,Jamaica,15,32,0,47
2013,Mayo,5,5/1/2013,Japón,113,516,0,629
2013,Mayo,5,5/1/2013,Jordania,1,7,0,8
2013,Mayo,5,5/1/2013,Kazajistán,1,0,0,1
2013,Mayo,5,5/1/2013,Kenia,5,3,0,8
2013,Mayo,5,5/1/2013,Kirguistán,0,1,0,1
2013,Mayo,5,5/1/2013,Kuwait,1,3,0,4
2013,Mayo,5,5/1/2013,República de Kosovo,2,0,0,2
2013,Mayo,5,5/1/2013,Letonia,5,17,0,22
2013,Mayo,5,5/1/2013,Lituania,11,15,0,26
2013,Mayo,5,5/1/2013,Líbano,19,32,0,51
2013,Mayo,5,5/1/2013,Liechtenstein,0,1,0,1
2013,Mayo,5,5/1/2013,Luxemburgo,1,8,0,9
2013,Mayo,5,5/1/2013,Macedonia,1,2,0,3
2013,Mayo,5,5/1/2013,Malasia,8,35,0,43
2013,Mayo,5,5/1/2013,Malta,0,8,0,8
2013,Mayo,5,5/1/2013,Marruecos,2,7,0,9
2013,Mayo,5,5/1/2013,Mauricio,1,1,0,2
2013,Mayo,5,5/1/2013,México,2193,5313,0,7506
2013,Mayo,5,5/1/2013,República de Moldavia,0,1,0,1
2013,Mayo,5,5/1/2013,Mozambique,1,1,0,2
2013,Mayo,5,5/1/2013,Nepal,1,2,0,3
2013,Mayo,5,5/1/2013,Nicaragua,58,84,0,142
2013,Mayo,5,5/1/2013,Nigeria,4,26,0,30
2013,Mayo,5,5/1/2013,Noruega,54,88,0,142
2013,Mayo,5,5/1/2013,Nueva Zelanda,40,98,0,138
2013,Mayo,5,5/1/2013,Omán,4,4,0,8
2013,Mayo,5,5/1/2013,Pakistán,0,8,0,8
2013,Mayo,5,5/1/2013,Palau,0,1,0,1
2013,Mayo,5,5/1/2013,Panamá,1276,1889,0,3165
2013,Mayo,5,5/1/2013,Paraguay,109,146,0,255
2013,Mayo,5,5/1/2013,Perú,3872,4828,0,8700
2013,Mayo,5,5/1/2013,Palestina,0,4,0,4
2013,Mayo,5,5/1/2013,Polonia,59,108,0,167
2013,Mayo,5,5/1/2013,Portugal,204,510,0,714
2013,Mayo,5,5/1/2013,Puerto Rico/Territorio de Estados Unidos,4,0,0,4
2013,Mayo,5,5/1/2013,Qatar,0,2,0,2
2013,Mayo,5,5/1/2013,Reino Unido de Gran Bretaña e Irlanda del Norte,592,1366,0,1958
2013,Mayo,5,5/1/2013,Federación de Rusia,112,204,0,316
2013,Mayo,5,5/1/2013,República Dominicana,304,551,0,855
2013,Mayo,5,5/1/2013,Rumania,31,58,0,89
2013,Mayo,5,5/1/2013,San Cristóbal y Nevis,3,2,0,5
2013,Mayo,5,5/1/2013,San  Vicente y las Granadinas,0,1,0,1
2013,Mayo,5,5/1/2013,Santa Lucia,2,1,0,3
2013,Mayo,5,5/1/2013,Santa Sede/Ciudad del Vaticano,0,3,0,3
2013,Mayo,5,5/1/2013,Senegal,0,1,0,1
2013,Mayo,5,5/1/2013,Serbia,4,10,0,14
2013,Mayo,5,5/1/2013,Singapur,13,17,0,30
2013,Mayo,5,5/1/2013,República Árabe Siria,0,1,0,1
2013,Mayo,5,5/1/2013,Sri Lanka,3,5,0,8
2013,Mayo,5,5/1/2013,Sudáfrica,34,81,0,115
2013,Mayo,5,5/1/2013,Suecia,117,206,0,323
2013,Mayo,5,5/1/2013,Suiza,334,593,0,927
2013,Mayo,5,5/1/2013,Surinam,12,25,0,37
2013,Mayo,5,5/1/2013,Taiwán,40,86,0,126
2013,Mayo,5,5/1/2013,Tailandia,8,8,0,16
2013,Mayo,5,5/1/2013,Tíbet/Región Autónoma de China,2,1,0,3
2013,Mayo,5,5/1/2013,Territorio Antártico Británico/Territorio Británico de Ultramar,1,1,0,2
2013,Mayo,5,5/1/2013,Tanzania,0,4,0,4
2013,Mayo,5,5/1/2013,Togo,0,3,0,3
2013,Mayo,5,5/1/2013,Trinidad y Tobago,17,61,0,78
2013,Mayo,5,5/1/2013,Túnez,0,3,0,3
2013,Mayo,5,5/1/2013,Turkmenistán,1,0,0,1
2013,Mayo,5,5/1/2013,Turquía,24,88,0,112
2013,Mayo,5,5/1/2013,Ucrania,14,24,0,38
2013,Mayo,5,5/1/2013,Uganda,1,2,0,3
2013,Mayo,5,5/1/2013,Uruguay,393,556,0,949
2013,Mayo,5,5/1/2013,Uzbekistán,0,1,0,1
2013,Mayo,5,5/1/2013,Venezuela,7198,9946,0,17144
2013,Mayo,5,5/1/2013,Vietnam,0,13,0,13
2013,Mayo,5,5/1/2013,Islas Vírgenes Británicas/Territorio Británico de Ultramar,0,1,0,1
2013,Mayo,5,5/1/2013,Zimbabue,0,4,0,4
2013,Mayo,5,5/1/2013,Islas Turcas y Caicos/Territorio Británico de Ultramar,1,1,0,2
2013,Junio,6,6/1/2013,Afganistán,0,3,0,3
2013,Junio,6,6/1/2013,Albania,1,4,0,5
2013,Junio,6,6/1/2013,Alemania,1169,1828,0,2997
2013,Junio,6,6/1/2013,Andorra,0,12,0,12
2013,Junio,6,6/1/2013,Angola,1,2,0,3
2013,Junio,6,6/1/2013,Antigua y Barbuda,0,2,0,2
2013,Junio,6,6/1/2013,Países Bajos,993,1467,0,2460
2013,Junio,6,6/1/2013,Arabia Saudita,1,11,0,12
2013,Junio,6,6/1/2013,Argelia,1,3,0,4
2013,Junio,6,6/1/2013,Argentina,4013,5544,0,9557
2013,Junio,6,6/1/2013,Aruba,4,6,0,10
2013,Junio,6,6/1/2013,Australia,310,516,0,826
2013,Junio,6,6/1/2013,Austria,84,202,0,286
2013,Junio,6,6/1/2013,Azerbaiyán,1,2,0,3
2013,Junio,6,6/1/2013,Bahamas,6,5,0,11
2013,Junio,6,6/1/2013,Bangladesh,1,3,0,4
2013,Junio,6,6/1/2013,Barbados,5,10,0,15
2013,Junio,6,6/1/2013,República de Belarús,4,4,0,8
2013,Junio,6,6/1/2013,Bélgica,201,377,0,578
2013,Junio,6,6/1/2013,Belice,3,17,0,20
2013,Junio,6,6/1/2013,Bermudas/Territorio Británico de Ultramar,1,3,0,4
2013,Junio,6,6/1/2013,Bolivia,351,569,0,920
2013,Junio,6,6/1/2013,Bosnia y Herzegovina,2,8,0,10
2013,Junio,6,6/1/2013,Botsuana,0,2,0,2
2013,Junio,6,6/1/2013,Brasil,2714,4238,0,6952
2013,Junio,6,6/1/2013,Bulgaria,10,9,0,19
2013,Junio,6,6/1/2013,Burkina Faso,1,1,0,2
2013,Junio,6,6/1/2013,Cabo Verde,0,2,0,2
2013,Junio,6,6/1/2013,Islas Caimán/Territorio Británico de Ultramar,3,5,0,8
2013,Junio,6,6/1/2013,Camerún,2,4,0,6
2013,Junio,6,6/1/2013,Canadá,901,1579,0,2480
2013,Junio,6,6/1/2013,España,2576,5928,0,8504
2013,Junio,6,6/1/2013,República Democrática del Congo,1,2,0,3
2013,Junio,6,6/1/2013,República de Corea,131,390,0,521
2013,Junio,6,6/1/2013,Costa de Marfil,0,4,0,4
2013,Junio,6,6/1/2013,Costa Rica,867,1354,0,2221
2013,Junio,6,6/1/2013,Croacia,6,33,0,39
2013,Junio,6,6/1/2013,Cuba,123,218,0,341
2013,Junio,6,6/1/2013,Curazao,5,6,0,11
2013,Junio,6,6/1/2013,República Checa,32,44,0,76
2013,Junio,6,6/1/2013,Chile,2787,4216,0,7003
2013,Junio,6,6/1/2013,China,182,473,0,655
2013,Junio,6,6/1/2013,Chipre,0,3,0,3
2013,Junio,6,6/1/2013,Dinamarca,70,152,0,222
2013,Junio,6,6/1/2013,Dominica,0,5,0,5
2013,Junio,6,6/1/2013,Ecuador,3163,5452,0,8615
2013,Junio,6,6/1/2013,Egipto,2,15,0,17
2013,Junio,6,6/1/2013,El Salvador,468,780,0,1248
2013,Junio,6,6/1/2013,Emiratos Árabes,2,12,0,14
2013,Junio,6,6/1/2013,Eslovaquia,11,26,0,37
2013,Junio,6,6/1/2013,Eslovenia,11,27,0,38
2013,Junio,6,6/1/2013,Estados Unidos de América,14736,22452,0,37188
2013,Junio,6,6/1/2013,Estonia,5,1,0,6
2013,Junio,6,6/1/2013,Etiopia,0,4,0,4
2013,Junio,6,6/1/2013,Filipinas,20,176,0,196
2013,Junio,6,6/1/2013,Finlandia,44,48,0,92
2013,Junio,6,6/1/2013,Francia,1032,1862,0,2894
2013,Junio,6,6/1/2013,Georgia,1,1,0,2
2013,Junio,6,6/1/2013,Granada,0,3,0,3
2013,Junio,6,6/1/2013,Grecia,16,65,0,81
2013,Junio,6,6/1/2013,Guatemala,369,807,0,1176
2013,Junio,6,6/1/2013,Guyana,10,19,0,29
2013,Junio,6,6/1/2013,Guayana Francesa/Departamento de Ultramar Francés,0,1,0,1
2013,Junio,6,6/1/2013,Haití,9,14,0,23
2013,Junio,6,6/1/2013,Honduras,181,303,0,484
2013,Junio,6,6/1/2013,Hong Kong,2,0,0,2
2013,Junio,6,6/1/2013,Hungría,12,18,0,30
2013,Junio,6,6/1/2013,India,48,303,0,351
2013,Junio,6,6/1/2013,Indonesia,10,37,0,47
2013,Junio,6,6/1/2013,Iraq,0,1,0,1
2013,Junio,6,6/1/2013,Irán,9,17,0,26
2013,Junio,6,6/1/2013,República de Irlanda,137,160,0,297
2013,Junio,6,6/1/2013,Islandia,6,4,0,10
2013,Junio,6,6/1/2013,Isla de Man,75,163,0,238
2013,Junio,6,6/1/2013,Isla Johnston,0,1,0,1
2013,Junio,6,6/1/2013,Israel,138,557,0,695
2013,Junio,6,6/1/2013,Isla Wake,12,5,0,17
2013,Junio,6,6/1/2013,Italia,544,1624,0,2168
2013,Junio,6,6/1/2013,Islas del Canal,1,2,0,3
2013,Junio,6,6/1/2013,Jamaica,22,48,0,70
2013,Junio,6,6/1/2013,Japón,115,492,0,607
2013,Junio,6,6/1/2013,Jordania,1,3,0,4
2013,Junio,6,6/1/2013,Kazajistán,4,2,0,6
2013,Junio,6,6/1/2013,Kenia,4,10,0,14
2013,Junio,6,6/1/2013,Kirguistán,0,1,0,1
2013,Junio,6,6/1/2013,Kuwait,1,3,0,4
2013,Junio,6,6/1/2013,República de Kosovo,0,1,0,1
2013,Junio,6,6/1/2013,Letonia,10,5,0,15
2013,Junio,6,6/1/2013,Lituania,13,18,0,31
2013,Junio,6,6/1/2013,Líbano,20,45,0,65
2013,Junio,6,6/1/2013,Libia,0,1,0,1
2013,Junio,6,6/1/2013,Luxemburgo,1,6,0,7
2013,Junio,6,6/1/2013,Macedonia,0,3,0,3
2013,Junio,6,6/1/2013,Madagascar,0,1,0,1
2013,Junio,6,6/1/2013,Malasia,10,24,0,34
2013,Junio,6,6/1/2013,Malí,0,1,0,1
2013,Junio,6,6/1/2013,Malta,1,1,0,2
2013,Junio,6,6/1/2013,Marruecos,3,10,0,13
2013,Junio,6,6/1/2013,Mauricio,1,1,0,2
2013,Junio,6,6/1/2013,México,2290,5358,0,7648
2013,Junio,6,6/1/2013,República de Moldavia,2,1,0,3
2013,Junio,6,6/1/2013,Mónaco,0,1,0,1
2013,Junio,6,6/1/2013,Montenegro,0,1,0,1
2013,Junio,6,6/1/2013,Mozambique,0,2,0,2
2013,Junio,6,6/1/2013,Myanmar,2,3,0,5
2013,Junio,6,6/1/2013,Nepal,4,6,0,10
2013,Junio,6,6/1/2013,Nicaragua,69,88,0,157
2013,Junio,6,6/1/2013,Nigeria,2,2,0,4
2013,Junio,6,6/1/2013,Noruega,104,163,0,267
2013,Junio,6,6/1/2013,Nueva Zelanda,43,95,0,138
2013,Junio,6,6/1/2013,Pakistán,2,11,0,13
2013,Junio,6,6/1/2013,Panamá,885,1522,0,2407
2013,Junio,6,6/1/2013,Paraguay,158,292,0,450
2013,Junio,6,6/1/2013,Perú,2866,4633,0,7499
2013,Junio,6,6/1/2013,Palestina,1,2,0,3
2013,Junio,6,6/1/2013,Polonia,63,80,0,143
2013,Junio,6,6/1/2013,Portugal,97,344,0,441
2013,Junio,6,6/1/2013,Puerto Rico/Territorio de Estados Unidos,3,1,0,4
2013,Junio,6,6/1/2013,Qatar,1,5,0,6
2013,Junio,6,6/1/2013,Reino Unido de Gran Bretaña e Irlanda del Norte,662,1326,0,1988
2013,Junio,6,6/1/2013,Federación de Rusia,113,179,0,292
2013,Junio,6,6/1/2013,República Dominicana,301,576,0,877
2013,Junio,6,6/1/2013,Rumania,32,73,0,105
2013,Junio,6,6/1/2013,Rwanda,0,2,0,2
2013,Junio,6,6/1/2013,San Cristóbal y Nevis,1,6,0,7
2013,Junio,6,6/1/2013,Samoa Occidental,1,0,0,1
2013,Junio,6,6/1/2013,San  Vicente y las Granadinas,1,6,0,7
2013,Junio,6,6/1/2013,Santa Lucia,3,4,0,7
2013,Junio,6,6/1/2013,Senegal,1,1,0,2
2013,Junio,6,6/1/2013,Serbia,5,10,0,15
2013,Junio,6,6/1/2013,Singapur,16,24,0,40
2013,Junio,6,6/1/2013,República Árabe Siria,2,2,0,4
2013,Junio,6,6/1/2013,Sri Lanka,1,3,0,4
2013,Junio,6,6/1/2013,Sudáfrica,33,84,0,117
2013,Junio,6,6/1/2013,Suecia,198,298,0,496
2013,Junio,6,6/1/2013,Suiza,338,601,0,939
2013,Junio,6,6/1/2013,Surinam,14,17,0,31
2013,Junio,6,6/1/2013,Taiwán,58,87,0,145
2013,Junio,6,6/1/2013,República de Tayikistán,0,1,0,1
2013,Junio,6,6/1/2013,Tailandia,2,4,0,6
2013,Junio,6,6/1/2013,Territorio Antártico Británico/Territorio Británico de Ultramar,2,2,0,4
2013,Junio,6,6/1/2013,Tanzania,0,2,0,2
2013,Junio,6,6/1/2013,Trinidad y Tobago,30,71,0,101
2013,Junio,6,6/1/2013,Túnez,2,2,0,4
2013,Junio,6,6/1/2013,Turquía,29,98,0,127
2013,Junio,6,6/1/2013,Ucrania,20,19,0,39
2013,Junio,6,6/1/2013,Uganda,0,3,0,3
2013,Junio,6,6/1/2013,Uruguay,397,614,0,1011
2013,Junio,6,6/1/2013,Venezuela,7776,10379,0,18155
2013,Junio,6,6/1/2013,Vietnam,1,1,0,2
2013,Junio,6,6/1/2013,República Árabe de Yemen,0,1,0,1
2013,Junio,6,6/1/2013,Zambia,0,1,0,1
2013,Junio,6,6/1/2013,Zimbabue,0,2,0,2
2013,Junio,6,6/1/2013,Desconocido,0,2,0,2
2013,Julio,7,7/1/2013,Afganistán,0,2,0,2
2013,Julio,7,7/1/2013,Albania,2,2,0,4
2013,Julio,7,7/1/2013,Alemania,1857,2689,0,4546
2013,Julio,7,7/1/2013,Andorra,2,12,0,14
2013,Julio,7,7/1/2013,Angola,1,2,0,3
2013,Julio,7,7/1/2013,Antigua y Barbuda,2,3,0,5
2013,Julio,7,7/1/2013,Países Bajos,1717,2257,0,3974
2013,Julio,7,7/1/2013,Arabia Saudita,3,16,0,19
2013,Julio,7,7/1/2013,Argelia,2,8,0,10
2013,Julio,7,7/1/2013,Argentina,4547,5987,0,10534
2013,Julio,7,7/1/2013,República de Armenia,0,9,0,9
2013,Julio,7,7/1/2013,Aruba,7,3,0,10
2013,Julio,7,7/1/2013,Australia,396,664,0,1060
2013,Julio,7,7/1/2013,Austria,246,337,0,583
2013,Julio,7,7/1/2013,Azerbaiyán,2,14,0,16
2013,Julio,7,7/1/2013,Bahamas,7,12,0,19
2013,Julio,7,7/1/2013,Bangladesh,1,10,0,11
2013,Julio,7,7/1/2013,Barbados,24,21,0,45
2013,Julio,7,7/1/2013,República de Belarús,23,17,0,40
2013,Julio,7,7/1/2013,Bélgica,345,597,0,942
2013,Julio,7,7/1/2013,Belice,18,16,0,34
2013,Julio,7,7/1/2013,Benín,1,0,0,1
2013,Julio,7,7/1/2013,Bermudas/Territorio Británico de Ultramar,1,6,0,7
2013,Julio,7,7/1/2013,Bolivia,406,582,0,988
2013,Julio,7,7/1/2013,Bosnia y Herzegovina,2,7,0,9
2013,Julio,7,7/1/2013,Brasil,3646,5170,0,8816
2013,Julio,7,7/1/2013,Bulgaria,19,20,0,39
2013,Julio,7,7/1/2013,Burkina Faso,2,1,0,3
2013,Julio,7,7/1/2013,Islas Caimán/Territorio Británico de Ultramar,5,3,0,8
2013,Julio,7,7/1/2013,Camboya,0,1,0,1
2013,Julio,7,7/1/2013,Camerún,0,3,0,3
2013,Julio,7,7/1/2013,Canadá,1200,2086,0,3286
2013,Julio,7,7/1/2013,España,2668,5996,0,8664
2013,Julio,7,7/1/2013,República Del Congo,0,2,0,2
2013,Julio,7,7/1/2013,República Democrática del Congo,1,4,0,5
2013,Julio,7,7/1/2013,República de Corea,172,433,0,605
2013,Julio,7,7/1/2013,Costa de Marfil,1,1,0,2
2013,Julio,7,7/1/2013,Costa Rica,1262,1597,0,2859
2013,Julio,7,7/1/2013,Croacia,13,56,0,69
2013,Julio,7,7/1/2013,Cuba,183,347,0,530
2013,Julio,7,7/1/2013,Curazao,4,7,0,11
2013,Julio,7,7/1/2013,República Checa,59,148,0,207
2013,Julio,7,7/1/2013,Chile,4004,4910,0,8914
2013,Julio,7,7/1/2013,China,284,549,0,833
2013,Julio,7,7/1/2013,Chipre,1,18,0,19
2013,Julio,7,7/1/2013,Dinamarca,119,220,0,339
2013,Julio,7,7/1/2013,Dominica,0,4,0,4
2013,Julio,7,7/1/2013,Ecuador,4494,6612,0,11106
2013,Julio,7,7/1/2013,Egipto,11,31,0,42
2013,Julio,7,7/1/2013,El Salvador,598,949,0,1547
2013,Julio,7,7/1/2013,Emiratos Árabes,1,2,0,3
2013,Julio,7,7/1/2013,Eritrea,1,1,0,2
2013,Julio,7,7/1/2013,Eslovaquia,25,38,0,63
2013,Julio,7,7/1/2013,Eslovenia,21,41,0,62
2013,Julio,7,7/1/2013,Estados Unidos de América,14084,22289,0,36373
2013,Julio,7,7/1/2013,Estonia,17,27,0,44
2013,Julio,7,7/1/2013,Etiopia,3,0,0,3
2013,Julio,7,7/1/2013,Filipinas,29,321,0,350
2013,Julio,7,7/1/2013,Finlandia,58,66,0,124
2013,Julio,7,7/1/2013,Francia,1891,3138,0,5029
2013,Julio,7,7/1/2013,Georgia,2,9,0,11
2013,Julio,7,7/1/2013,Ghana,1,1,0,2
2013,Julio,7,7/1/2013,Granada,2,3,0,5
2013,Julio,7,7/1/2013,Grecia,14,80,0,94
2013,Julio,7,7/1/2013,Guatemala,356,808,0,1164
2013,Julio,7,7/1/2013,Guyana,9,16,0,25
2013,Julio,7,7/1/2013,Guinea,0,1,0,1
2013,Julio,7,7/1/2013,Guinea Ecuatorial,2,1,0,3
2013,Julio,7,7/1/2013,Guinea Bissau,0,1,0,1
2013,Julio,7,7/1/2013,Haití,7,20,0,27
2013,Julio,7,7/1/2013,Honduras,241,368,0,609
2013,Julio,7,7/1/2013,Hungría,72,89,0,161
2013,Julio,7,7/1/2013,India,65,346,0,411
2013,Julio,7,7/1/2013,Indonesia,16,45,0,61
2013,Julio,7,7/1/2013,Iraq,0,1,0,1
2013,Julio,7,7/1/2013,Irán,8,44,0,52
2013,Julio,7,7/1/2013,República de Irlanda,153,229,0,382
2013,Julio,7,7/1/2013,Islandia,5,12,0,17
2013,Julio,7,7/1/2013,Isla de Man,147,273,0,420
2013,Julio,7,7/1/2013,Islas Pitcairn/Territorio Británico de Ultramar,0,1,0,1
2013,Julio,7,7/1/2013,Isla Johnston,2,0,0,2
2013,Julio,7,7/1/2013,Israel,157,666,0,823
2013,Julio,7,7/1/2013,Islas Aland/Provincia de Finlandia,0,1,0,1
2013,Julio,7,7/1/2013,Isla Wake,4,2,0,6
2013,Julio,7,7/1/2013,Italia,731,1985,0,2716
2013,Julio,7,7/1/2013,Islas del Canal,1,7,0,8
2013,Julio,7,7/1/2013,Jamaica,39,37,0,76
2013,Julio,7,7/1/2013,Islas Salomón,1,0,0,1
2013,Julio,7,7/1/2013,Japón,198,632,0,830
2013,Julio,7,7/1/2013,Jordania,3,8,0,11
2013,Julio,7,7/1/2013,Kazajistán,5,12,0,17
2013,Julio,7,7/1/2013,Kenia,8,10,0,18
2013,Julio,7,7/1/2013,Kirguistán,1,10,0,11
2013,Julio,7,7/1/2013,Kuwait,0,1,0,1
2013,Julio,7,7/1/2013,República de Kosovo,1,8,0,9
2013,Julio,7,7/1/2013,Letonia,14,59,0,73
2013,Julio,7,7/1/2013,Lituania,20,25,0,45
2013,Julio,7,7/1/2013,Líbano,25,33,0,58
2013,Julio,7,7/1/2013,Liechtenstein,5,5,0,10
2013,Julio,7,7/1/2013,Luxemburgo,9,25,0,34
2013,Julio,7,7/1/2013,Macedonia,2,11,0,13
2013,Julio,7,7/1/2013,Madagascar,2,1,0,3
2013,Julio,7,7/1/2013,Malasia,19,50,0,69
2013,Julio,7,7/1/2013,Malta,1,4,0,5
2013,Julio,7,7/1/2013,Marruecos,5,18,0,23
2013,Julio,7,7/1/2013,Mauricio,1,4,0,5
2013,Julio,7,7/1/2013,Mauritania,0,1,0,1
2013,Julio,7,7/1/2013,México,3969,7120,0,11089
2013,Julio,7,7/1/2013,Mayotte/Colectividad Territorial Francesa,0,1,0,1
2013,Julio,7,7/1/2013,República de Moldavia,4,5,0,9
2013,Julio,7,7/1/2013,Mónaco,1,0,0,1
2013,Julio,7,7/1/2013,Mongolia,5,25,0,30
2013,Julio,7,7/1/2013,Montenegro,6,7,0,13
2013,Julio,7,7/1/2013,Namibia,0,1,0,1
2013,Julio,7,7/1/2013,Nepal,1,1,0,2
2013,Julio,7,7/1/2013,Nicaragua,88,109,0,197
2013,Julio,7,7/1/2013,Nigeria,5,12,0,17
2013,Julio,7,7/1/2013,Noruega,180,269,0,449
2013,Julio,7,7/1/2013,Nueva Caledonia/Territorio francés,1,0,0,1
2013,Julio,7,7/1/2013,Nueva Zelanda,84,129,0,213
2013,Julio,7,7/1/2013,Papúa Nueva Guinea,1,1,0,2
2013,Julio,7,7/1/2013,Pakistán,3,19,0,22
2013,Julio,7,7/1/2013,Panamá,1069,1843,0,2912
2013,Julio,7,7/1/2013,Paraguay,170,421,0,591
2013,Julio,7,7/1/2013,Perú,3985,5070,0,9055
2013,Julio,7,7/1/2013,Palestina,1,1,0,2
2013,Julio,7,7/1/2013,Polonia,110,179,0,289
2013,Julio,7,7/1/2013,Portugal,143,449,0,592
2013,Julio,7,7/1/2013,Puerto Rico/Territorio de Estados Unidos,1,3,0,4
2013,Julio,7,7/1/2013,Qatar,0,16,0,16
2013,Julio,7,7/1/2013,Reino Unido de Gran Bretaña e Irlanda del Norte,1004,1895,0,2899
2013,Julio,7,7/1/2013,República CentroÁfricana,0,2,0,2
2013,Julio,7,7/1/2013,Federación de Rusia,220,372,0,592
2013,Julio,7,7/1/2013,República Dominicana,343,620,0,963
2013,Julio,7,7/1/2013,República Democrática Popular de Corea,0,8,0,8
2013,Julio,7,7/1/2013,Rumania,55,67,0,122
2013,Julio,7,7/1/2013,San Cristóbal y Nevis,1,4,0,5
2013,Julio,7,7/1/2013,San  Vicente y las Granadinas,0,5,0,5
2013,Julio,7,7/1/2013,Santa Lucia,3,11,0,14
2013,Julio,7,7/1/2013,Santa Sede/Ciudad del Vaticano,0,3,0,3
2013,Julio,7,7/1/2013,Santo Tomé y Príncipe,0,1,0,1
2013,Julio,7,7/1/2013,Senegal,2,5,0,7
2013,Julio,7,7/1/2013,Serbia,11,20,0,31
2013,Julio,7,7/1/2013,Singapur,24,44,0,68
2013,Julio,7,7/1/2013,República Árabe Siria,0,4,0,4
2013,Julio,7,7/1/2013,Sri Lanka,3,10,0,13
2013,Julio,7,7/1/2013,Sudáfrica,59,136,0,195
2013,Julio,7,7/1/2013,Suecia,167,323,0,490
2013,Julio,7,7/1/2013,Suiza,737,1097,0,1834
2013,Julio,7,7/1/2013,Surinam,8,33,0,41
2013,Julio,7,7/1/2013,Taiwán,100,146,0,246
2013,Julio,7,7/1/2013,República de Tayikistán,0,1,0,1
2013,Julio,7,7/1/2013,Tailandia,18,30,0,48
2013,Julio,7,7/1/2013,Tíbet/Región Autónoma de China,2,1,0,3
2013,Julio,7,7/1/2013,Territorio Antártico Británico/Territorio Británico de Ultramar,4,5,0,9
2013,Julio,7,7/1/2013,Tanzania,0,2,0,2
2013,Julio,7,7/1/2013,República Democrática de Timor Oriental,0,1,0,1
2013,Julio,7,7/1/2013,Trinidad y Tobago,102,138,0,240
2013,Julio,7,7/1/2013,Túnez,7,13,0,20
2013,Julio,7,7/1/2013,Turkmenistán,0,13,0,13
2013,Julio,7,7/1/2013,Turquía,38,127,0,165
2013,Julio,7,7/1/2013,Ucrania,88,131,0,219
2013,Julio,7,7/1/2013,Uganda,4,10,0,14
2013,Julio,7,7/1/2013,Uruguay,316,546,0,862
2013,Julio,7,7/1/2013,Venezuela,10132,12499,0,22631
2013,Julio,7,7/1/2013,Vietnam,10,24,0,34
2013,Julio,7,7/1/2013,Zambia,0,1,0,1
2013,Julio,7,7/1/2013,Zimbabue,1,1,0,2
2013,Julio,7,7/1/2013,Desconocido,0,1,0,1
2013,Agosto,8,8/1/2013,Albania,3,5,0,8
2013,Agosto,8,8/1/2013,Alemania,1879,2572,0,4451
2013,Agosto,8,8/1/2013,Andorra,3,15,0,18
2013,Agosto,8,8/1/2013,Angola,1,1,0,2
2013,Agosto,8,8/1/2013,Antigua y Barbuda,1,4,0,5
2013,Agosto,8,8/1/2013,Países Bajos,881,1380,0,2261
2013,Agosto,8,8/1/2013,Arabia Saudita,0,5,0,5
2013,Agosto,8,8/1/2013,Argelia,1,2,0,3
2013,Agosto,8,8/1/2013,Argentina,4400,5984,0,10384
2013,Agosto,8,8/1/2013,República de Armenia,1,2,0,3
2013,Agosto,8,8/1/2013,Aruba,4,4,0,8
2013,Agosto,8,8/1/2013,Australia,331,533,0,864
2013,Agosto,8,8/1/2013,Austria,179,265,0,444
2013,Agosto,8,8/1/2013,Azerbaiyán,0,2,0,2
2013,Agosto,8,8/1/2013,Bahamas,8,16,0,24
2013,Agosto,8,8/1/2013,Bangladesh,1,2,0,3
2013,Agosto,8,8/1/2013,Barbados,8,14,0,22
2013,Agosto,8,8/1/2013,República de Belarús,3,2,0,5
2013,Agosto,8,8/1/2013,Bélgica,174,355,0,529
2013,Agosto,8,8/1/2013,Belice,11,18,0,29
2013,Agosto,8,8/1/2013,Bermudas/Territorio Británico de Ultramar,0,3,0,3
2013,Agosto,8,8/1/2013,Bolivia,383,515,0,898
2013,Agosto,8,8/1/2013,Bosnia y Herzegovina,4,0,0,4
2013,Agosto,8,8/1/2013,Botsuana,1,0,0,1
2013,Agosto,8,8/1/2013,Brasil,3137,4716,0,7853
2013,Agosto,8,8/1/2013,Bulgaria,10,18,0,28
2013,Agosto,8,8/1/2013,Burkina Faso,0,1,0,1
2013,Agosto,8,8/1/2013,Burundi,1,4,0,5
2013,Agosto,8,8/1/2013,Bután,1,0,0,1
2013,Agosto,8,8/1/2013,Islas Caimán/Territorio Británico de Ultramar,4,2,0,6
2013,Agosto,8,8/1/2013,Camboya,3,4,0,7
2013,Agosto,8,8/1/2013,Canadá,1100,1818,0,2918
2013,Agosto,8,8/1/2013,España,3122,5953,0,9075
2013,Agosto,8,8/1/2013,República Democrática del Congo,5,6,0,11
2013,Agosto,8,8/1/2013,República de Corea,271,491,0,762
2013,Agosto,8,8/1/2013,Costa de Marfil,0,1,0,1
2013,Agosto,8,8/1/2013,Costa Rica,1009,1400,0,2409
2013,Agosto,8,8/1/2013,Croacia,10,25,0,35
2013,Agosto,8,8/1/2013,Cuba,167,339,0,506
2013,Agosto,8,8/1/2013,Curazao,7,3,0,10
2013,Agosto,8,8/1/2013,República Checa,29,46,0,75
2013,Agosto,8,8/1/2013,Chile,3395,4557,0,7952
2013,Agosto,8,8/1/2013,China,189,427,0,616
2013,Agosto,8,8/1/2013,Chipre,0,5,0,5
2013,Agosto,8,8/1/2013,Dinamarca,62,125,0,187
2013,Agosto,8,8/1/2013,Dominica,1,3,0,4
2013,Agosto,8,8/1/2013,Ecuador,4718,6312,0,11030
2013,Agosto,8,8/1/2013,Egipto,6,15,0,21
2013,Agosto,8,8/1/2013,El Salvador,726,934,0,1660
2013,Agosto,8,8/1/2013,Emiratos Árabes,1,10,0,11
2013,Agosto,8,8/1/2013,Eslovaquia,17,18,0,35
2013,Agosto,8,8/1/2013,Eslovenia,20,18,0,38
2013,Agosto,8,8/1/2013,Estados Unidos de América,11403,20544,0,31947
2013,Agosto,8,8/1/2013,Estonia,5,6,0,11
2013,Agosto,8,8/1/2013,Etiopia,2,6,0,8
2013,Agosto,8,8/1/2013,Islas Fiji,1,0,0,1
2013,Agosto,8,8/1/2013,Filipinas,19,214,0,233
2013,Agosto,8,8/1/2013,Finlandia,32,67,0,99
2013,Agosto,8,8/1/2013,Francia,1634,2786,0,4420
2013,Agosto,8,8/1/2013,Gabón,2,2,0,4
2013,Agosto,8,8/1/2013,Georgia,4,1,0,5
2013,Agosto,8,8/1/2013,Ghana,3,4,0,7
2013,Agosto,8,8/1/2013,Granada,0,2,0,2
2013,Agosto,8,8/1/2013,Grecia,34,61,0,95
2013,Agosto,8,8/1/2013,Guatemala,306,720,0,1026
2013,Agosto,8,8/1/2013,Guyana,5,14,0,19
2013,Agosto,8,8/1/2013,Guinea,0,1,0,1
2013,Agosto,8,8/1/2013,Guinea Bissau,0,1,0,1
2013,Agosto,8,8/1/2013,Guayana Francesa/Departamento de Ultramar Francés,0,1,0,1
2013,Agosto,8,8/1/2013,Haití,6,16,0,22
2013,Agosto,8,8/1/2013,Honduras,258,350,0,608
2013,Agosto,8,8/1/2013,Hong Kong,0,1,0,1
2013,Agosto,8,8/1/2013,Hungría,24,28,0,52
2013,Agosto,8,8/1/2013,India,73,332,0,405
2013,Agosto,8,8/1/2013,Indonesia,20,25,0,45
2013,Agosto,8,8/1/2013,Iraq,2,19,0,21
2013,Agosto,8,8/1/2013,Irán,9,12,0,21
2013,Agosto,8,8/1/2013,República de Irlanda,110,175,0,285
2013,Agosto,8,8/1/2013,Islandia,5,2,0,7
2013,Agosto,8,8/1/2013,Isla de Man,86,177,0,263
2013,Agosto,8,8/1/2013,Isla Johnston,1,1,0,2
2013,Agosto,8,8/1/2013,Israel,171,589,0,760
2013,Agosto,8,8/1/2013,Islas Aland/Provincia de Finlandia,1,0,0,1
2013,Agosto,8,8/1/2013,Isla Wake,2,1,0,3
2013,Agosto,8,8/1/2013,Italia,873,2251,0,3124
2013,Agosto,8,8/1/2013,Islas del Canal,2,8,0,10
2013,Agosto,8,8/1/2013,Jamaica,24,43,0,67
2013,Agosto,8,8/1/2013,Japón,173,560,0,733
2013,Agosto,8,8/1/2013,Jordania,1,2,0,3
2013,Agosto,8,8/1/2013,Kazajistán,1,0,0,1
2013,Agosto,8,8/1/2013,Kenia,6,10,0,16
2013,Agosto,8,8/1/2013,Kirguistán,1,1,0,2
2013,Agosto,8,8/1/2013,Kuwait,0,2,0,2
2013,Agosto,8,8/1/2013,República Democrática Popular  Lao,2,2,0,4
2013,Agosto,8,8/1/2013,Letonia,6,4,0,10
2013,Agosto,8,8/1/2013,Lituania,10,7,0,17
2013,Agosto,8,8/1/2013,Líbano,15,35,0,50
2013,Agosto,8,8/1/2013,Liberia,1,0,0,1
2013,Agosto,8,8/1/2013,Libia,2,0,0,2
2013,Agosto,8,8/1/2013,Liechtenstein,1,1,0,2
2013,Agosto,8,8/1/2013,Luxemburgo,7,16,0,23
2013,Agosto,8,8/1/2013,Macedonia,2,2,0,4
2013,Agosto,8,8/1/2013,Madagascar,0,1,0,1
2013,Agosto,8,8/1/2013,Malasia,13,20,0,33
2013,Agosto,8,8/1/2013,Malawi,0,1,0,1
2013,Agosto,8,8/1/2013,Maldivas,0,1,0,1
2013,Agosto,8,8/1/2013,Malta,3,1,0,4
2013,Agosto,8,8/1/2013,Marruecos,2,8,0,10
2013,Agosto,8,8/1/2013,Mauritania,0,2,0,2
2013,Agosto,8,8/1/2013,México,3144,6510,0,9654
2013,Agosto,8,8/1/2013,Mayotte/Colectividad Territorial Francesa,0,1,0,1
2013,Agosto,8,8/1/2013,Mónaco,4,4,0,8
2013,Agosto,8,8/1/2013,Mongolia,0,1,0,1
2013,Agosto,8,8/1/2013,Montenegro,1,0,0,1
2013,Agosto,8,8/1/2013,Mozambique,0,1,0,1
2013,Agosto,8,8/1/2013,Myanmar,2,3,0,5
2013,Agosto,8,8/1/2013,Namibia,0,1,0,1
2013,Agosto,8,8/1/2013,Nepal,1,1,0,2
2013,Agosto,8,8/1/2013,Nicaragua,66,138,0,204
2013,Agosto,8,8/1/2013,Nigeria,1,8,0,9
2013,Agosto,8,8/1/2013,Noruega,53,111,0,164
2013,Agosto,8,8/1/2013,Nueva Zelanda,66,117,0,183
2013,Agosto,8,8/1/2013,Papúa Nueva Guinea,0,1,0,1
2013,Agosto,8,8/1/2013,Pakistán,4,13,0,17
2013,Agosto,8,8/1/2013,Panamá,1097,1877,0,2974
2013,Agosto,8,8/1/2013,Paraguay,117,175,0,292
2013,Agosto,8,8/1/2013,Perú,4183,5447,0,9630
2013,Agosto,8,8/1/2013,Palestina,2,1,0,3
2013,Agosto,8,8/1/2013,Polonia,106,126,0,232
2013,Agosto,8,8/1/2013,Portugal,134,363,0,497
2013,Agosto,8,8/1/2013,Puerto Rico/Territorio de Estados Unidos,1,1,0,2
2013,Agosto,8,8/1/2013,Qatar,0,1,0,1
2013,Agosto,8,8/1/2013,Reino Unido de Gran Bretaña e Irlanda del Norte,774,1533,0,2307
2013,Agosto,8,8/1/2013,Federación de Rusia,134,155,0,289
2013,Agosto,8,8/1/2013,República Dominicana,386,645,0,1031
2013,Agosto,8,8/1/2013,Rumania,30,62,0,92
2013,Agosto,8,8/1/2013,Rwanda,2,1,0,3
2013,Agosto,8,8/1/2013,San Cristóbal y Nevis,2,12,0,14
2013,Agosto,8,8/1/2013,San  Vicente y las Granadinas,1,5,0,6
2013,Agosto,8,8/1/2013,Santa Lucia,3,1,0,4
2013,Agosto,8,8/1/2013,Santa Sede/Ciudad del Vaticano,0,2,0,2
2013,Agosto,8,8/1/2013,Senegal,0,5,0,5
2013,Agosto,8,8/1/2013,Serbia,7,9,0,16
2013,Agosto,8,8/1/2013,Singapur,8,28,0,36
2013,Agosto,8,8/1/2013,República Árabe Siria,1,8,0,9
2013,Agosto,8,8/1/2013,Sri Lanka,0,3,0,3
2013,Agosto,8,8/1/2013,Sudáfrica,47,100,0,147
2013,Agosto,8,8/1/2013,Sudán,0,1,0,1
2013,Agosto,8,8/1/2013,Suecia,117,188,0,305
2013,Agosto,8,8/1/2013,Suiza,365,555,0,920
2013,Agosto,8,8/1/2013,Surinam,46,27,0,73
2013,Agosto,8,8/1/2013,Taiwán,71,93,0,164
2013,Agosto,8,8/1/2013,Tailandia,6,11,0,17
2013,Agosto,8,8/1/2013,Territorio Antártico Británico/Territorio Británico de Ultramar,1,4,0,5
2013,Agosto,8,8/1/2013,Trinidad y Tobago,35,69,0,104
2013,Agosto,8,8/1/2013,Túnez,2,5,0,7
2013,Agosto,8,8/1/2013,Turquía,34,79,0,113
2013,Agosto,8,8/1/2013,Ucrania,18,40,0,58
2013,Agosto,8,8/1/2013,Uganda,6,4,0,10
2013,Agosto,8,8/1/2013,Uruguay,326,533,0,859
2013,Agosto,8,8/1/2013,Uzbekistán,2,0,0,2
2013,Agosto,8,8/1/2013,Venezuela,11545,13005,0,24550
2013,Agosto,8,8/1/2013,Vietnam,1,8,0,9
2013,Agosto,8,8/1/2013,Islas Vírgenes Británicas/Territorio Británico de Ultramar,0,1,0,1
2013,Agosto,8,8/1/2013,República Árabe de Yemen,1,0,0,1
2013,Agosto,8,8/1/2013,Zambia,1,1,0,2
2013,Agosto,8,8/1/2013,Zimbabue,0,3,0,3
2013,Agosto,8,8/1/2013,Anguila/Territorio Británico de Ultramar,0,1,0,1
2013,Agosto,8,8/1/2013,Desconocido,0,1,0,1
2013,Septiembre,9,9/1/2013,Albania,2,4,0,6
2013,Septiembre,9,9/1/2013,Alemania,1243,2047,0,3290
2013,Septiembre,9,9/1/2013,Andorra,1,5,0,6
2013,Septiembre,9,9/1/2013,Antigua y Barbuda,4,9,0,13
2013,Septiembre,9,9/1/2013,Países Bajos,819,1464,0,2283
2013,Septiembre,9,9/1/2013,Arabia Saudita,0,14,0,14
2013,Septiembre,9,9/1/2013,Argelia,1,3,0,4
2013,Septiembre,9,9/1/2013,Argentina,4355,5669,0,10024
2013,Septiembre,9,9/1/2013,República de Armenia,1,1,0,2
2013,Septiembre,9,9/1/2013,Aruba,2,0,0,2
2013,Septiembre,9,9/1/2013,Australia,278,508,0,786
2013,Septiembre,9,9/1/2013,Austria,87,212,0,299
2013,Septiembre,9,9/1/2013,Azerbaiyán,1,0,0,1
2013,Septiembre,9,9/1/2013,Bahamas,4,15,0,19
2013,Septiembre,9,9/1/2013,Bangladesh,1,6,0,7
2013,Septiembre,9,9/1/2013,Barbados,11,20,0,31
2013,Septiembre,9,9/1/2013,República de Belarús,2,7,0,9
2013,Septiembre,9,9/1/2013,Bélgica,134,373,0,507
2013,Septiembre,9,9/1/2013,Belice,4,27,0,31
2013,Septiembre,9,9/1/2013,Benín,1,0,0,1
2013,Septiembre,9,9/1/2013,Bermudas/Territorio Británico de Ultramar,0,3,0,3
2013,Septiembre,9,9/1/2013,Bolivia,367,532,0,899
2013,Septiembre,9,9/1/2013,Botsuana,1,2,0,3
2013,Septiembre,9,9/1/2013,Brasil,3651,5250,0,8901
2013,Septiembre,9,9/1/2013,Bulgaria,10,14,0,24
2013,Septiembre,9,9/1/2013,Burkina Faso,2,9,0,11
2013,Septiembre,9,9/1/2013,Islas Caimán/Territorio Británico de Ultramar,1,0,0,1
2013,Septiembre,9,9/1/2013,Camerún,0,6,0,6
2013,Septiembre,9,9/1/2013,Canadá,650,1561,0,2211
2013,Septiembre,9,9/1/2013,Chad,0,2,0,2
2013,Septiembre,9,9/1/2013,España,2279,6113,0,8392
2013,Septiembre,9,9/1/2013,República Democrática del Congo,1,2,0,3
2013,Septiembre,9,9/1/2013,República de Corea,126,408,0,534
2013,Septiembre,9,9/1/2013,Costa de Marfil,1,7,0,8
2013,Septiembre,9,9/1/2013,Costa Rica,949,1422,0,2371
2013,Septiembre,9,9/1/2013,Croacia,6,30,0,36
2013,Septiembre,9,9/1/2013,Cuba,120,266,0,386
2013,Septiembre,9,9/1/2013,Curazao,2,4,0,6
2013,Septiembre,9,9/1/2013,República Checa,33,48,0,81
2013,Septiembre,9,9/1/2013,Chile,3516,4472,0,7988
2013,Septiembre,9,9/1/2013,China,128,384,0,512
2013,Septiembre,9,9/1/2013,Chipre,2,3,0,5
2013,Septiembre,9,9/1/2013,Dinamarca,43,125,0,168
2013,Septiembre,9,9/1/2013,Dominica,5,5,0,10
2013,Septiembre,9,9/1/2013,Ecuador,3977,6571,0,10548
2013,Septiembre,9,9/1/2013,Egipto,3,25,0,28
2013,Septiembre,9,9/1/2013,El Salvador,535,865,0,1400
2013,Septiembre,9,9/1/2013,Emiratos Árabes,1,9,0,10
2013,Septiembre,9,9/1/2013,Eslovaquia,12,22,0,34
2013,Septiembre,9,9/1/2013,Eslovenia,5,23,0,28
2013,Septiembre,9,9/1/2013,Estados Unidos de América,6652,15413,0,22065
2013,Septiembre,9,9/1/2013,Estonia,5,5,0,10
2013,Septiembre,9,9/1/2013,Etiopia,3,7,0,10
2013,Septiembre,9,9/1/2013,Filipinas,25,262,0,287
2013,Septiembre,9,9/1/2013,Finlandia,28,65,0,93
2013,Septiembre,9,9/1/2013,Francia,812,1776,0,2588
2013,Septiembre,9,9/1/2013,Gabón,1,4,0,5
2013,Septiembre,9,9/1/2013,Georgia,1,1,0,2
2013,Septiembre,9,9/1/2013,Ghana,1,7,0,8
2013,Septiembre,9,9/1/2013,Gibraltar/Territorio Británico de Ultramar,1,0,0,1
2013,Septiembre,9,9/1/2013,Granada,5,2,0,7
2013,Septiembre,9,9/1/2013,Grecia,26,70,0,96
2013,Septiembre,9,9/1/2013,Guatemala,326,734,0,1060
2013,Septiembre,9,9/1/2013,Guyana,13,20,0,33
2013,Septiembre,9,9/1/2013,Guinea Ecuatorial,1,1,0,2
2013,Septiembre,9,9/1/2013,Haití,11,37,0,48
2013,Septiembre,9,9/1/2013,Honduras,230,347,0,577
2013,Septiembre,9,9/1/2013,Hong Kong,0,1,0,1
2013,Septiembre,9,9/1/2013,Hungría,23,34,0,57
2013,Septiembre,9,9/1/2013,India,35,256,0,291
2013,Septiembre,9,9/1/2013,Indonesia,10,38,0,48
2013,Septiembre,9,9/1/2013,Iraq,0,1,0,1
2013,Septiembre,9,9/1/2013,Irán,4,8,0,12
2013,Septiembre,9,9/1/2013,República de Irlanda,87,179,0,266
2013,Septiembre,9,9/1/2013,Islandia,2,34,0,36
2013,Septiembre,9,9/1/2013,Isla de Man,41,88,0,129
2013,Septiembre,9,9/1/2013,Isla Johnston,0,2,0,2
2013,Septiembre,9,9/1/2013,Israel,104,426,0,530
2013,Septiembre,9,9/1/2013,Italia,448,1655,0,2103
2013,Septiembre,9,9/1/2013,Islas del Canal,1,7,0,8
2013,Septiembre,9,9/1/2013,Jamaica,20,45,0,65
2013,Septiembre,9,9/1/2013,Japón,135,500,0,635
2013,Septiembre,9,9/1/2013,Jordania,0,5,0,5
2013,Septiembre,9,9/1/2013,Kazajistán,4,6,0,10
2013,Septiembre,9,9/1/2013,Kenia,9,17,0,26
2013,Septiembre,9,9/1/2013,Kirguistán,0,1,0,1
2013,Septiembre,9,9/1/2013,Kuwait,0,6,0,6
2013,Septiembre,9,9/1/2013,República de Kosovo,1,0,0,1
2013,Septiembre,9,9/1/2013,Letonia,9,9,0,18
2013,Septiembre,9,9/1/2013,Lituania,18,12,0,30
2013,Septiembre,9,9/1/2013,Líbano,25,35,0,60
2013,Septiembre,9,9/1/2013,Liberia,1,0,0,1
2013,Septiembre,9,9/1/2013,Liechtenstein,3,2,0,5
2013,Septiembre,9,9/1/2013,Luxemburgo,3,9,0,12
2013,Septiembre,9,9/1/2013,Macedonia,1,1,0,2
2013,Septiembre,9,9/1/2013,Madagascar,0,1,0,1
2013,Septiembre,9,9/1/2013,Malasia,13,28,0,41
2013,Septiembre,9,9/1/2013,Malawi,1,2,0,3
2013,Septiembre,9,9/1/2013,Malí,2,2,0,4
2013,Septiembre,9,9/1/2013,Malta,4,2,0,6
2013,Septiembre,9,9/1/2013,Marruecos,7,8,0,15
2013,Septiembre,9,9/1/2013,Mauricio,1,0,0,1
2013,Septiembre,9,9/1/2013,Mauritania,3,1,0,4
2013,Septiembre,9,9/1/2013,México,2888,6164,0,9052
2013,Septiembre,9,9/1/2013,República de Moldavia,4,0,0,4
2013,Septiembre,9,9/1/2013,Mongolia,2,0,0,2
2013,Septiembre,9,9/1/2013,Mozambique,2,3,0,5
2013,Septiembre,9,9/1/2013,Namibia,2,5,0,7
2013,Septiembre,9,9/1/2013,Nepal,0,3,0,3
2013,Septiembre,9,9/1/2013,Nicaragua,77,131,0,208
2013,Septiembre,9,9/1/2013,Nigeria,3,20,0,23
2013,Septiembre,9,9/1/2013,Níger,0,5,0,5
2013,Septiembre,9,9/1/2013,Noruega,40,120,0,160
2013,Septiembre,9,9/1/2013,Nueva Zelanda,35,98,0,133
2013,Septiembre,9,9/1/2013,Omán,0,1,0,1
2013,Septiembre,9,9/1/2013,Pakistán,0,11,0,11
2013,Septiembre,9,9/1/2013,Panamá,1171,1692,0,2863
2013,Septiembre,9,9/1/2013,Paraguay,135,200,0,335
2013,Septiembre,9,9/1/2013,Perú,3486,4744,0,8230
2013,Septiembre,9,9/1/2013,Palestina,0,1,0,1
2013,Septiembre,9,9/1/2013,Polonia,71,121,0,192
2013,Septiembre,9,9/1/2013,Portugal,103,380,0,483
2013,Septiembre,9,9/1/2013,Qatar,0,2,0,2
2013,Septiembre,9,9/1/2013,Reino Unido de Gran Bretaña e Irlanda del Norte,577,1545,0,2122
2013,Septiembre,9,9/1/2013,República CentroÁfricana,5,1,0,6
2013,Septiembre,9,9/1/2013,Federación de Rusia,167,223,0,390
2013,Septiembre,9,9/1/2013,República Dominicana,353,598,0,951
2013,Septiembre,9,9/1/2013,República Democrática Popular de Corea,0,1,0,1
2013,Septiembre,9,9/1/2013,Rumania,37,59,0,96
2013,Septiembre,9,9/1/2013,San Cristóbal y Nevis,3,9,0,12
2013,Septiembre,9,9/1/2013,San  Vicente y las Granadinas,2,4,0,6
2013,Septiembre,9,9/1/2013,Santa Lucia,4,9,0,13
2013,Septiembre,9,9/1/2013,Senegal,3,8,0,11
2013,Septiembre,9,9/1/2013,Serbia,4,3,0,7
2013,Septiembre,9,9/1/2013,Seychelles,1,0,0,1
2013,Septiembre,9,9/1/2013,Singapur,10,27,0,37
2013,Septiembre,9,9/1/2013,República Árabe Siria,1,0,0,1
2013,Septiembre,9,9/1/2013,Sri Lanka,2,2,0,4
2013,Septiembre,9,9/1/2013,Sudáfrica,42,85,0,127
2013,Septiembre,9,9/1/2013,Sudán,1,2,0,3
2013,Septiembre,9,9/1/2013,Suecia,114,212,0,326
2013,Septiembre,9,9/1/2013,Suiza,268,533,0,801
2013,Septiembre,9,9/1/2013,Surinam,26,35,0,61
2013,Septiembre,9,9/1/2013,Taiwán,38,71,0,109
2013,Septiembre,9,9/1/2013,Tailandia,4,8,0,12
2013,Septiembre,9,9/1/2013,Territorio Antártico Británico/Territorio Británico de Ultramar,1,2,0,3
2013,Septiembre,9,9/1/2013,Tanzania,3,6,0,9
2013,Septiembre,9,9/1/2013,Togo,0,4,0,4
2013,Septiembre,9,9/1/2013,Trinidad y Tobago,79,86,0,165
2013,Septiembre,9,9/1/2013,Túnez,1,2,0,3
2013,Septiembre,9,9/1/2013,Turkmenistán,1,0,0,1
2013,Septiembre,9,9/1/2013,Turquía,27,167,0,194
2013,Septiembre,9,9/1/2013,Ucrania,21,73,0,94
2013,Septiembre,9,9/1/2013,Uganda,7,9,0,16
2013,Septiembre,9,9/1/2013,Uruguay,327,543,0,870
2013,Septiembre,9,9/1/2013,Uzbekistán,0,3,0,3
2013,Septiembre,9,9/1/2013,Venezuela,8956,11128,0,20084
2013,Septiembre,9,9/1/2013,Vietnam,6,20,0,26
2013,Septiembre,9,9/1/2013,Islas Vírgenes Británicas/Territorio Británico de Ultramar,1,0,0,1
2013,Septiembre,9,9/1/2013,Yugoslavia,1,0,0,1
2013,Septiembre,9,9/1/2013,Zambia,1,7,0,8
2013,Septiembre,9,9/1/2013,Zimbabue,3,5,0,8
2013,Septiembre,9,9/1/2013,Desconocido,4,24,0,28
2013,Octubre,10,10/1/2013,Afganistán,2,2,0,4
2013,Octubre,10,10/1/2013,Albania,0,2,0,2
2013,Octubre,10,10/1/2013,Alemania,1330,2271,0,3601
2013,Octubre,10,10/1/2013,Andorra,2,17,0,19
2013,Octubre,10,10/1/2013,Angola,3,31,0,34
2013,Octubre,10,10/1/2013,Antigua y Barbuda,2,9,0,11
2013,Octubre,10,10/1/2013,Países Bajos,1072,1700,0,2772
2013,Octubre,10,10/1/2013,Arabia Saudita,0,10,0,10
2013,Octubre,10,10/1/2013,Argelia,0,10,0,10
2013,Octubre,10,10/1/2013,Argentina,4056,5546,0,9602
2013,Octubre,10,10/1/2013,República de Armenia,0,2,0,2
2013,Octubre,10,10/1/2013,Aruba,1,3,0,4
2013,Octubre,10,10/1/2013,Australia,280,510,0,790
2013,Octubre,10,10/1/2013,Austria,94,219,0,313
2013,Octubre,10,10/1/2013,Azerbaiyán,2,4,0,6
2013,Octubre,10,10/1/2013,Bahamas,4,10,0,14
2013,Octubre,10,10/1/2013,Bahréin,0,5,0,5
2013,Octubre,10,10/1/2013,Bangladesh,0,4,0,4
2013,Octubre,10,10/1/2013,Barbados,4,17,0,21
2013,Octubre,10,10/1/2013,República de Belarús,2,5,0,7
2013,Octubre,10,10/1/2013,Bélgica,153,407,0,560
2013,Octubre,10,10/1/2013,Belice,5,15,0,20
2013,Octubre,10,10/1/2013,Benín,2,2,0,4
2013,Octubre,10,10/1/2013,Bermudas/Territorio Británico de Ultramar,1,3,0,4
2013,Octubre,10,10/1/2013,Bolivia,334,524,0,858
2013,Octubre,10,10/1/2013,Bosnia y Herzegovina,2,1,0,3
2013,Octubre,10,10/1/2013,Botsuana,0,5,0,5
2013,Octubre,10,10/1/2013,Brasil,3440,5002,0,8442
2013,Octubre,10,10/1/2013,Brunei Darussalam,0,5,0,5
2013,Octubre,10,10/1/2013,Bulgaria,11,22,0,33
2013,Octubre,10,10/1/2013,Burkina Faso,0,2,0,2
2013,Octubre,10,10/1/2013,Burundi,0,3,0,3
2013,Octubre,10,10/1/2013,Bután,0,2,0,2
2013,Octubre,10,10/1/2013,Cabo Verde,1,0,0,1
2013,Octubre,10,10/1/2013,Islas Caimán/Territorio Británico de Ultramar,2,1,0,3
2013,Octubre,10,10/1/2013,Camboya,0,1,0,1
2013,Octubre,10,10/1/2013,Camerún,4,9,0,13
2013,Octubre,10,10/1/2013,Canadá,757,1562,0,2319
2013,Octubre,10,10/1/2013,Chad,0,1,0,1
2013,Octubre,10,10/1/2013,España,2377,6318,0,8695
2013,Octubre,10,10/1/2013,República Del Congo,0,2,0,2
2013,Octubre,10,10/1/2013,Comoras,0,2,0,2
2013,Octubre,10,10/1/2013,República Democrática del Congo,4,19,0,23
2013,Octubre,10,10/1/2013,República de Corea,147,483,0,630
2013,Octubre,10,10/1/2013,Costa de Marfil,1,6,0,7
2013,Octubre,10,10/1/2013,Costa Rica,619,1093,0,1712
2013,Octubre,10,10/1/2013,Croacia,3,47,0,50
2013,Octubre,10,10/1/2013,Cuba,147,279,0,426
2013,Octubre,10,10/1/2013,Curazao,0,2,0,2
2013,Octubre,10,10/1/2013,República Checa,41,63,0,104
2013,Octubre,10,10/1/2013,Chile,3315,5643,0,8958
2013,Octubre,10,10/1/2013,China,167,498,0,665
2013,Octubre,10,10/1/2013,Chipre,1,4,0,5
2013,Octubre,10,10/1/2013,Dinamarca,51,125,0,176
2013,Octubre,10,10/1/2013,Dominica,2,5,0,7
2013,Octubre,10,10/1/2013,Ecuador,4388,6377,0,10765
2013,Octubre,10,10/1/2013,Egipto,5,16,0,21
2013,Octubre,10,10/1/2013,El Salvador,593,983,0,1576
2013,Octubre,10,10/1/2013,Emiratos Árabes,3,12,0,15
2013,Octubre,10,10/1/2013,Eslovaquia,10,25,0,35
2013,Octubre,10,10/1/2013,Eslovenia,13,23,0,36
2013,Octubre,10,10/1/2013,Estados Unidos de América,7135,15596,0,22731
2013,Octubre,10,10/1/2013,Estonia,4,9,0,13
2013,Octubre,10,10/1/2013,Etiopia,1,12,0,13
2013,Octubre,10,10/1/2013,Islas Fiji,1,6,0,7
2013,Octubre,10,10/1/2013,Filipinas,27,262,0,289
2013,Octubre,10,10/1/2013,Finlandia,36,71,0,107
2013,Octubre,10,10/1/2013,Francia,1005,2078,0,3083
2013,Octubre,10,10/1/2013,Gabón,0,3,0,3
2013,Octubre,10,10/1/2013,Georgia,1,6,0,7
2013,Octubre,10,10/1/2013,Ghana,0,5,0,5
2013,Octubre,10,10/1/2013,Granada,0,1,0,1
2013,Octubre,10,10/1/2013,Grecia,22,71,0,93
2013,Octubre,10,10/1/2013,Guatemala,337,713,0,1050
2013,Octubre,10,10/1/2013,Guyana,5,14,0,19
2013,Octubre,10,10/1/2013,Guinea,0,4,0,4
2013,Octubre,10,10/1/2013,Guinea Ecuatorial,1,0,0,1
2013,Octubre,10,10/1/2013,Guinea Bissau,0,2,0,2
2013,Octubre,10,10/1/2013,Haití,3,37,0,40
2013,Octubre,10,10/1/2013,Honduras,197,344,0,541
2013,Octubre,10,10/1/2013,Hong Kong,0,1,0,1
2013,Octubre,10,10/1/2013,Hungría,20,45,0,65
2013,Octubre,10,10/1/2013,India,44,290,0,334
2013,Octubre,10,10/1/2013,Indonesia,7,57,0,64
2013,Octubre,10,10/1/2013,Iraq,0,9,0,9
2013,Octubre,10,10/1/2013,Irán,3,26,0,29
2013,Octubre,10,10/1/2013,República de Irlanda,63,141,0,204
2013,Octubre,10,10/1/2013,Islandia,5,7,0,12
2013,Octubre,10,10/1/2013,Isla de Man,9,12,0,21
2013,Octubre,10,10/1/2013,Israel,70,499,0,569
2013,Octubre,10,10/1/2013,Italia,507,1919,0,2426
2013,Octubre,10,10/1/2013,Islas del Canal,1,2,0,3
2013,Octubre,10,10/1/2013,Jamaica,15,43,0,58
2013,Octubre,10,10/1/2013,Japón,126,486,0,612
2013,Octubre,10,10/1/2013,Jordania,1,7,0,8
2013,Octubre,10,10/1/2013,Kazajistán,0,1,0,1
2013,Octubre,10,10/1/2013,Kenia,4,14,0,18
2013,Octubre,10,10/1/2013,Kirguistán,2,1,0,3
2013,Octubre,10,10/1/2013,Kuwait,0,10,0,10
2013,Octubre,10,10/1/2013,República de Kosovo,1,0,0,1
2013,Octubre,10,10/1/2013,Lesoto,0,4,0,4
2013,Octubre,10,10/1/2013,Letonia,9,14,0,23
2013,Octubre,10,10/1/2013,Lituania,7,9,0,16
2013,Octubre,10,10/1/2013,Líbano,17,35,0,52
2013,Octubre,10,10/1/2013,Liberia,0,1,0,1
2013,Octubre,10,10/1/2013,Libia,0,1,0,1
2013,Octubre,10,10/1/2013,Liechtenstein,1,3,0,4
2013,Octubre,10,10/1/2013,Luxemburgo,5,17,0,22
2013,Octubre,10,10/1/2013,Macedonia,2,1,0,3
2013,Octubre,10,10/1/2013,Madagascar,2,2,0,4
2013,Octubre,10,10/1/2013,Malasia,12,33,0,45
2013,Octubre,10,10/1/2013,Malawi,2,5,0,7
2013,Octubre,10,10/1/2013,Malí,0,3,0,3
2013,Octubre,10,10/1/2013,Malta,2,8,0,10
2013,Octubre,10,10/1/2013,Marruecos,4,8,0,12
2013,Octubre,10,10/1/2013,Islas Marshall,0,1,0,1
2013,Octubre,10,10/1/2013,Mauritania,0,2,0,2
2013,Octubre,10,10/1/2013,México,2667,6017,0,8684
2013,Octubre,10,10/1/2013,República de Moldavia,2,3,0,5
2013,Octubre,10,10/1/2013,Mónaco,2,3,0,5
2013,Octubre,10,10/1/2013,Mongolia,2,3,0,5
2013,Octubre,10,10/1/2013,Montenegro,0,2,0,2
2013,Octubre,10,10/1/2013,Mozambique,0,8,0,8
2013,Octubre,10,10/1/2013,Myanmar,0,3,0,3
2013,Octubre,10,10/1/2013,Namibia,2,6,0,8
2013,Octubre,10,10/1/2013,Nepal,0,6,0,6
2013,Octubre,10,10/1/2013,Nicaragua,104,149,0,253
2013,Octubre,10,10/1/2013,Nigeria,2,14,0,16
2013,Octubre,10,10/1/2013,Níger,0,3,0,3
2013,Octubre,10,10/1/2013,Noruega,67,139,0,206
2013,Octubre,10,10/1/2013,Nueva Caledonia/Territorio francés,0,1,0,1
2013,Octubre,10,10/1/2013,Nueva Zelanda,44,97,0,141
2013,Octubre,10,10/1/2013,Omán,0,3,0,3
2013,Octubre,10,10/1/2013,Pakistán,0,13,0,13
2013,Octubre,10,10/1/2013,Panamá,984,1756,0,2740
2013,Octubre,10,10/1/2013,Paraguay,116,165,0,281
2013,Octubre,10,10/1/2013,Perú,3861,4860,0,8721
2013,Octubre,10,10/1/2013,Palestina,3,3,0,6
2013,Octubre,10,10/1/2013,Polonia,86,122,0,208
2013,Octubre,10,10/1/2013,Portugal,172,432,0,604
2013,Octubre,10,10/1/2013,Puerto Rico/Territorio de Estados Unidos,0,2,0,2
2013,Octubre,10,10/1/2013,Qatar,0,5,0,5
2013,Octubre,10,10/1/2013,Reino Unido de Gran Bretaña e Irlanda del Norte,613,1532,0,2145
2013,Octubre,10,10/1/2013,República CentroÁfricana,0,1,0,1
2013,Octubre,10,10/1/2013,Federación de Rusia,186,256,0,442
2013,Octubre,10,10/1/2013,República Dominicana,320,464,0,784
2013,Octubre,10,10/1/2013,Rumania,51,101,0,152
2013,Octubre,10,10/1/2013,Rwanda,0,3,0,3
2013,Octubre,10,10/1/2013,Sahara Occidental/Desierto Sahara,0,1,0,1
2013,Octubre,10,10/1/2013,San Cristóbal y Nevis,1,3,0,4
2013,Octubre,10,10/1/2013,Samoa Occidental,1,0,0,1
2013,Octubre,10,10/1/2013,San Marino,1,0,0,1
2013,Octubre,10,10/1/2013,San  Vicente y las Granadinas,1,5,0,6
2013,Octubre,10,10/1/2013,Santa Lucia,4,1,0,5
2013,Octubre,10,10/1/2013,Santa Sede/Ciudad del Vaticano,0,2,0,2
2013,Octubre,10,10/1/2013,Senegal,0,4,0,4
2013,Octubre,10,10/1/2013,Serbia,6,16,0,22
2013,Octubre,10,10/1/2013,Sierra Leona,0,2,0,2
2013,Octubre,10,10/1/2013,Singapur,25,41,0,66
2013,Octubre,10,10/1/2013,República Árabe Siria,0,3,0,3
2013,Octubre,10,10/1/2013,Sri Lanka,3,5,0,8
2013,Octubre,10,10/1/2013,Sudáfrica,32,87,0,119
2013,Octubre,10,10/1/2013,Sudán,0,16,0,16
2013,Octubre,10,10/1/2013,Suecia,140,270,0,410
2013,Octubre,10,10/1/2013,Suiza,372,649,0,1021
2013,Octubre,10,10/1/2013,Surinam,10,29,0,39
2013,Octubre,10,10/1/2013,Suazilandia,1,1,0,2
2013,Octubre,10,10/1/2013,Taiwán,47,84,0,131
2013,Octubre,10,10/1/2013,Tailandia,8,8,0,16
2013,Octubre,10,10/1/2013,Tíbet/Región Autónoma de China,1,0,0,1
2013,Octubre,10,10/1/2013,Territorio Antártico Británico/Territorio Británico de Ultramar,0,2,0,2
2013,Octubre,10,10/1/2013,Tanzania,3,4,0,7
2013,Octubre,10,10/1/2013,Togo,0,1,0,1
2013,Octubre,10,10/1/2013,Trinidad y Tobago,55,103,0,158
2013,Octubre,10,10/1/2013,Túnez,0,2,0,2
2013,Octubre,10,10/1/2013,Turkmenistán,0,3,0,3
2013,Octubre,10,10/1/2013,Turquía,41,108,0,149
2013,Octubre,10,10/1/2013,Ucrania,25,28,0,53
2013,Octubre,10,10/1/2013,Uganda,3,9,0,12
2013,Octubre,10,10/1/2013,Uruguay,291,481,0,772
2013,Octubre,10,10/1/2013,Uzbekistán,1,0,0,1
2013,Octubre,10,10/1/2013,Venezuela,9845,12456,0,22301
2013,Octubre,10,10/1/2013,Vietnam,3,8,0,11
2013,Octubre,10,10/1/2013,República Árabe de Yemen,0,1,0,1
2013,Octubre,10,10/1/2013,Zambia,3,3,0,6
2013,Octubre,10,10/1/2013,Zimbabue,3,5,0,8
2013,Octubre,10,10/1/2013,Islas Turcas y Caicos/Territorio Británico de Ultramar,1,2,0,3
2013,Octubre,10,10/1/2013,Desconocido,46,70,0,116
2013,Noviembre,11,11/1/2013,Afganistán,0,1,0,1
2013,Noviembre,11,11/1/2013,Albania,0,3,0,3
2013,Noviembre,11,11/1/2013,Alemania,1381,2467,0,3848
2013,Noviembre,11,11/1/2013,Andorra,0,8,0,8
2013,Noviembre,11,11/1/2013,Angola,3,1,0,4
2013,Noviembre,11,11/1/2013,Antigua y Barbuda,1,4,0,5
2013,Noviembre,11,11/1/2013,Países Bajos,832,1576,0,2408
2013,Noviembre,11,11/1/2013,Arabia Saudita,0,6,0,6
2013,Noviembre,11,11/1/2013,Argelia,1,4,0,5
2013,Noviembre,11,11/1/2013,Argentina,4520,6416,0,10936
2013,Noviembre,11,11/1/2013,República de Armenia,1,1,0,2
2013,Noviembre,11,11/1/2013,Aruba,0,1,0,1
2013,Noviembre,11,11/1/2013,Australia,412,611,0,1023
2013,Noviembre,11,11/1/2013,Austria,131,256,0,387
2013,Noviembre,11,11/1/2013,Azerbaiyán,0,2,0,2
2013,Noviembre,11,11/1/2013,Bahamas,8,14,0,22
2013,Noviembre,11,11/1/2013,Bahréin,1,1,0,2
2013,Noviembre,11,11/1/2013,Bangladesh,0,1,0,1
2013,Noviembre,11,11/1/2013,Barbados,5,7,0,12
2013,Noviembre,11,11/1/2013,República de Belarús,2,0,0,2
2013,Noviembre,11,11/1/2013,Bélgica,152,416,0,568
2013,Noviembre,11,11/1/2013,Belice,6,19,0,25
2013,Noviembre,11,11/1/2013,Bermudas/Territorio Británico de Ultramar,0,4,0,4
2013,Noviembre,11,11/1/2013,Bolivia,561,805,0,1366
2013,Noviembre,11,11/1/2013,Bosnia y Herzegovina,2,0,0,2
2013,Noviembre,11,11/1/2013,Brasil,3676,5396,0,9072
2013,Noviembre,11,11/1/2013,Bulgaria,15,17,0,32
2013,Noviembre,11,11/1/2013,Burkina Faso,0,2,0,2
2013,Noviembre,11,11/1/2013,Burundi,1,0,0,1
2013,Noviembre,11,11/1/2013,Bután,0,1,0,1
2013,Noviembre,11,11/1/2013,Islas Caimán/Territorio Británico de Ultramar,3,1,0,4
2013,Noviembre,11,11/1/2013,Camboya,0,2,0,2
2013,Noviembre,11,11/1/2013,Antártida,0,1,0,1
2013,Noviembre,11,11/1/2013,Camerún,1,1,0,2
2013,Noviembre,11,11/1/2013,Canadá,1029,2039,0,3068
2013,Noviembre,11,11/1/2013,España,2699,7115,0,9814
2013,Noviembre,11,11/1/2013,República Democrática del Congo,2,1,0,3
2013,Noviembre,11,11/1/2013,República de Corea,175,508,0,683
2013,Noviembre,11,11/1/2013,Costa de Marfil,0,7,0,7
2013,Noviembre,11,11/1/2013,Costa Rica,732,1247,0,1979
2013,Noviembre,11,11/1/2013,Croacia,1,46,0,47
2013,Noviembre,11,11/1/2013,Cuba,130,265,0,395
2013,Noviembre,11,11/1/2013,Curazao,0,1,0,1
2013,Noviembre,11,11/1/2013,República Checa,58,81,0,139
2013,Noviembre,11,11/1/2013,Chile,2684,4158,0,6842
2013,Noviembre,11,11/1/2013,China,207,530,0,737
2013,Noviembre,11,11/1/2013,Chipre,2,4,0,6
2013,Noviembre,11,11/1/2013,Dinamarca,55,140,0,195
2013,Noviembre,11,11/1/2013,Dominica,1,4,0,5
2013,Noviembre,11,11/1/2013,Ecuador,3812,6025,0,9837
2013,Noviembre,11,11/1/2013,Egipto,2,8,0,10
2013,Noviembre,11,11/1/2013,El Salvador,699,1022,0,1721
2013,Noviembre,11,11/1/2013,Emiratos Árabes,0,2,0,2
2013,Noviembre,11,11/1/2013,Eslovaquia,16,33,0,49
2013,Noviembre,11,11/1/2013,Eslovenia,19,39,0,58
2013,Noviembre,11,11/1/2013,Estados Unidos de América,8654,17572,0,26226
2013,Noviembre,11,11/1/2013,Estonia,6,7,0,13
2013,Noviembre,11,11/1/2013,Etiopia,0,3,0,3
2013,Noviembre,11,11/1/2013,Islas Fiji,0,1,0,1
2013,Noviembre,11,11/1/2013,Filipinas,29,180,0,209
2013,Noviembre,11,11/1/2013,Finlandia,59,77,0,136
2013,Noviembre,11,11/1/2013,Francia,969,2079,0,3048
2013,Noviembre,11,11/1/2013,Georgia,1,1,0,2
2013,Noviembre,11,11/1/2013,Ghana,1,7,0,8
2013,Noviembre,11,11/1/2013,Granada,0,1,0,1
2013,Noviembre,11,11/1/2013,Grecia,14,75,0,89
2013,Noviembre,11,11/1/2013,Guatemala,491,921,0,1412
2013,Noviembre,11,11/1/2013,Guyana,6,16,0,22
2013,Noviembre,11,11/1/2013,Guinea,0,1,0,1
2013,Noviembre,11,11/1/2013,Guinea Bissau,0,1,0,1
2013,Noviembre,11,11/1/2013,Haití,11,36,0,47
2013,Noviembre,11,11/1/2013,Honduras,171,309,0,480
2013,Noviembre,11,11/1/2013,Hong Kong,0,1,0,1
2013,Noviembre,11,11/1/2013,Hungría,30,56,0,86
2013,Noviembre,11,11/1/2013,India,39,298,0,337
2013,Noviembre,11,11/1/2013,Indonesia,12,31,0,43
2013,Noviembre,11,11/1/2013,Iraq,1,3,0,4
2013,Noviembre,11,11/1/2013,Irán,6,17,0,23
2013,Noviembre,11,11/1/2013,República de Irlanda,88,176,0,264
2013,Noviembre,11,11/1/2013,Islandia,7,5,0,12
2013,Noviembre,11,11/1/2013,Israel,67,429,0,496
2013,Noviembre,11,11/1/2013,Italia,571,2219,0,2790
2013,Noviembre,11,11/1/2013,Jamaica,17,42,0,59
2013,Noviembre,11,11/1/2013,Japón,126,572,0,698
2013,Noviembre,11,11/1/2013,Jordania,1,7,0,8
2013,Noviembre,11,11/1/2013,Kazajistán,3,6,0,9
2013,Noviembre,11,11/1/2013,Kenia,2,10,0,12
2013,Noviembre,11,11/1/2013,Kirguistán,1,1,0,2
2013,Noviembre,11,11/1/2013,Kuwait,0,2,0,2
2013,Noviembre,11,11/1/2013,Letonia,17,17,0,34
2013,Noviembre,11,11/1/2013,Lituania,27,12,0,39
2013,Noviembre,11,11/1/2013,Líbano,16,35,0,51
2013,Noviembre,11,11/1/2013,Liechtenstein,0,3,0,3
2013,Noviembre,11,11/1/2013,Luxemburgo,7,6,0,13
2013,Noviembre,11,11/1/2013,Madagascar,0,1,0,1
2013,Noviembre,11,11/1/2013,Malasia,18,22,0,40
2013,Noviembre,11,11/1/2013,Malta,1,6,0,7
2013,Noviembre,11,11/1/2013,Marruecos,4,14,0,18
2013,Noviembre,11,11/1/2013,Mauricio,1,1,0,2
2013,Noviembre,11,11/1/2013,Mauritania,0,2,0,2
2013,Noviembre,11,11/1/2013,México,3655,7050,0,10705
2013,Noviembre,11,11/1/2013,República de Moldavia,4,1,0,5
2013,Noviembre,11,11/1/2013,Mónaco,3,1,0,4
2013,Noviembre,11,11/1/2013,Mongolia,0,1,0,1
2013,Noviembre,11,11/1/2013,Mozambique,0,2,0,2
2013,Noviembre,11,11/1/2013,Myanmar,0,1,0,1
2013,Noviembre,11,11/1/2013,Namibia,0,1,0,1
2013,Noviembre,11,11/1/2013,Nepal,0,2,0,2
2013,Noviembre,11,11/1/2013,Nicaragua,103,137,0,240
2013,Noviembre,11,11/1/2013,Nigeria,4,10,0,14
2013,Noviembre,11,11/1/2013,Noruega,64,171,0,235
2013,Noviembre,11,11/1/2013,Nueva Zelanda,64,120,0,184
2013,Noviembre,11,11/1/2013,Pakistán,2,19,0,21
2013,Noviembre,11,11/1/2013,Panamá,1276,1909,0,3185
2013,Noviembre,11,11/1/2013,Paraguay,147,196,0,343
2013,Noviembre,11,11/1/2013,Perú,3210,4807,0,8017
2013,Noviembre,11,11/1/2013,Palestina,0,1,0,1
2013,Noviembre,11,11/1/2013,Polonia,106,160,0,266
2013,Noviembre,11,11/1/2013,Portugal,143,445,0,588
2013,Noviembre,11,11/1/2013,Puerto Rico/Territorio de Estados Unidos,1,0,0,1
2013,Noviembre,11,11/1/2013,Qatar,0,1,0,1
2013,Noviembre,11,11/1/2013,Reino Unido de Gran Bretaña e Irlanda del Norte,738,1650,0,2388
2013,Noviembre,11,11/1/2013,República CentroÁfricana,0,1,0,1
2013,Noviembre,11,11/1/2013,Federación de Rusia,206,292,0,498
2013,Noviembre,11,11/1/2013,República Dominicana,326,650,0,976
2013,Noviembre,11,11/1/2013,República Democrática Popular de Corea,0,1,0,1
2013,Noviembre,11,11/1/2013,Rumania,39,79,0,118
2013,Noviembre,11,11/1/2013,San Cristóbal y Nevis,1,0,0,1
2013,Noviembre,11,11/1/2013,Samoa Occidental,1,0,0,1
2013,Noviembre,11,11/1/2013,San Marino,0,1,0,1
2013,Noviembre,11,11/1/2013,San  Vicente y las Granadinas,1,2,0,3
2013,Noviembre,11,11/1/2013,Santa Lucia,4,2,0,6
2013,Noviembre,11,11/1/2013,Senegal,0,2,0,2
2013,Noviembre,11,11/1/2013,Serbia,3,13,0,16
2013,Noviembre,11,11/1/2013,Singapur,13,16,0,29
2013,Noviembre,11,11/1/2013,República Árabe Siria,0,1,0,1
2013,Noviembre,11,11/1/2013,Sri Lanka,0,1,0,1
2013,Noviembre,11,11/1/2013,Sudáfrica,59,140,0,199
2013,Noviembre,11,11/1/2013,Sudán,0,1,0,1
2013,Noviembre,11,11/1/2013,Suecia,201,335,0,536
2013,Noviembre,11,11/1/2013,Suiza,356,646,0,1002
2013,Noviembre,11,11/1/2013,Surinam,22,33,0,55
2013,Noviembre,11,11/1/2013,Taiwán,51,103,0,154
2013,Noviembre,11,11/1/2013,Tailandia,11,7,0,18
2013,Noviembre,11,11/1/2013,Tanzania,0,1,0,1
2013,Noviembre,11,11/1/2013,Togo,0,1,0,1
2013,Noviembre,11,11/1/2013,Trinidad y Tobago,25,73,0,98
2013,Noviembre,11,11/1/2013,Túnez,1,3,0,4
2013,Noviembre,11,11/1/2013,Turquía,28,148,0,176
2013,Noviembre,11,11/1/2013,Ucrania,19,57,0,76
2013,Noviembre,11,11/1/2013,Uganda,0,2,0,2
2013,Noviembre,11,11/1/2013,Uruguay,357,514,0,871
2013,Noviembre,11,11/1/2013,Venezuela,9981,12858,0,22839
2013,Noviembre,11,11/1/2013,Vietnam,3,4,0,7
2013,Noviembre,11,11/1/2013,República Árabe de Yemen,0,1,0,1
2013,Noviembre,11,11/1/2013,Zimbabue,1,2,0,3
2013,Noviembre,11,11/1/2013,Desconocido,48,83,0,131
2013,Diciembre,12,12/1/2013,Albania,0,5,0,5
2013,Diciembre,12,12/1/2013,Alemania,1587,2528,0,4115
2013,Diciembre,12,12/1/2013,Andorra,0,4,0,4
2013,Diciembre,12,12/1/2013,Angola,1,0,0,1
2013,Diciembre,12,12/1/2013,Antigua y Barbuda,0,7,0,7
2013,Diciembre,12,12/1/2013,Países Bajos,1044,1913,0,2957
2013,Diciembre,12,12/1/2013,Arabia Saudita,2,26,0,28
2013,Diciembre,12,12/1/2013,Argelia,3,4,0,7
2013,Diciembre,12,12/1/2013,Argentina,3726,4925,0,8651
2013,Diciembre,12,12/1/2013,República de Armenia,0,1,0,1
2013,Diciembre,12,12/1/2013,Australia,496,875,0,1371
2013,Diciembre,12,12/1/2013,Austria,139,284,0,423
2013,Diciembre,12,12/1/2013,Azerbaiyán,3,0,0,3
2013,Diciembre,12,12/1/2013,Bahamas,0,5,0,5
2013,Diciembre,12,12/1/2013,Bahréin,3,1,0,4
2013,Diciembre,12,12/1/2013,Bangladesh,0,3,0,3
2013,Diciembre,12,12/1/2013,Barbados,13,6,0,19
2013,Diciembre,12,12/1/2013,República de Belarús,3,2,0,5
2013,Diciembre,12,12/1/2013,Bélgica,169,456,0,625
2013,Diciembre,12,12/1/2013,Belice,11,15,0,26
2013,Diciembre,12,12/1/2013,Benín,3,1,0,4
2013,Diciembre,12,12/1/2013,Bermudas/Territorio Británico de Ultramar,0,2,0,2
2013,Diciembre,12,12/1/2013,Bolivia,616,581,0,1197
2013,Diciembre,12,12/1/2013,Bosnia y Herzegovina,0,1,0,1
2013,Diciembre,12,12/1/2013,Brasil,3902,4737,0,8639
2013,Diciembre,12,12/1/2013,Bulgaria,17,21,0,38
2013,Diciembre,12,12/1/2013,Burkina Faso,0,1,0,1
2013,Diciembre,12,12/1/2013,Burundi,0,1,0,1
2013,Diciembre,12,12/1/2013,Cabo Verde,0,1,0,1
2013,Diciembre,12,12/1/2013,Islas Caimán/Territorio Británico de Ultramar,4,10,0,14
2013,Diciembre,12,12/1/2013,Camboya,0,1,0,1
2013,Diciembre,12,12/1/2013,Camerún,0,1,0,1
2013,Diciembre,12,12/1/2013,Canadá,2338,3433,0,5771
2013,Diciembre,12,12/1/2013,España,2862,6117,0,8979
2013,Diciembre,12,12/1/2013,República Democrática del Congo,4,5,0,9
2013,Diciembre,12,12/1/2013,República de Corea,189,358,0,547
2013,Diciembre,12,12/1/2013,Costa de Marfil,1,0,0,1
2013,Diciembre,12,12/1/2013,Costa Rica,1325,1631,0,2956
2013,Diciembre,12,12/1/2013,Croacia,8,38,0,46
2013,Diciembre,12,12/1/2013,Cuba,137,282,0,419
2013,Diciembre,12,12/1/2013,Curazao,3,4,0,7
2013,Diciembre,12,12/1/2013,República Checa,43,55,0,98
2013,Diciembre,12,12/1/2013,Chile,1971,3160,0,5131
2013,Diciembre,12,12/1/2013,China,147,409,0,556
2013,Diciembre,12,12/1/2013,Chipre,1,11,0,12
2013,Diciembre,12,12/1/2013,Dinamarca,102,189,0,291
2013,Diciembre,12,12/1/2013,Dominica,0,3,0,3
2013,Diciembre,12,12/1/2013,Ecuador,4850,6894,0,11744
2013,Diciembre,12,12/1/2013,Egipto,2,13,0,15
2013,Diciembre,12,12/1/2013,El Salvador,532,789,0,1321
2013,Diciembre,12,12/1/2013,Emiratos Árabes,4,5,0,9
2013,Diciembre,12,12/1/2013,Eslovaquia,12,14,0,26
2013,Diciembre,12,12/1/2013,Eslovenia,21,36,0,57
2013,Diciembre,12,12/1/2013,Estados Unidos de América,15204,25484,0,40688
2013,Diciembre,12,12/1/2013,Estonia,7,12,0,19
2013,Diciembre,12,12/1/2013,Filipinas,25,161,0,186
2013,Diciembre,12,12/1/2013,Finlandia,75,114,0,189
2013,Diciembre,12,12/1/2013,Francia,1523,2691,0,4214
2013,Diciembre,12,12/1/2013,Gabón,0,1,0,1
2013,Diciembre,12,12/1/2013,Georgia,2,2,0,4
2013,Diciembre,12,12/1/2013,Ghana,2,0,0,2
2013,Diciembre,12,12/1/2013,Granada,0,4,0,4
2013,Diciembre,12,12/1/2013,Grecia,38,84,0,122
2013,Diciembre,12,12/1/2013,Guatemala,439,780,0,1219
2013,Diciembre,12,12/1/2013,Guyana,13,19,0,32
2013,Diciembre,12,12/1/2013,Guinea Ecuatorial,0,2,0,2
2013,Diciembre,12,12/1/2013,Haití,17,38,0,55
2013,Diciembre,12,12/1/2013,Honduras,230,298,0,528
2013,Diciembre,12,12/1/2013,Hungría,34,40,0,74
2013,Diciembre,12,12/1/2013,India,63,253,0,316
2013,Diciembre,12,12/1/2013,Indonesia,13,38,0,51
2013,Diciembre,12,12/1/2013,Iraq,0,2,0,2
2013,Diciembre,12,12/1/2013,Irán,1,16,0,17
2013,Diciembre,12,12/1/2013,República de Irlanda,87,174,0,261
2013,Diciembre,12,12/1/2013,Islandia,12,17,0,29
2013,Diciembre,12,12/1/2013,Israel,71,438,0,509
2013,Diciembre,12,12/1/2013,Italia,706,2129,0,2835
2013,Diciembre,12,12/1/2013,Jamaica,11,24,0,35
2013,Diciembre,12,12/1/2013,Japón,178,451,0,629
2013,Diciembre,12,12/1/2013,Jordania,2,6,0,8
2013,Diciembre,12,12/1/2013,Kazajistán,4,1,0,5
2013,Diciembre,12,12/1/2013,Kenia,8,13,0,21
2013,Diciembre,12,12/1/2013,Kirguistán,0,1,0,1
2013,Diciembre,12,12/1/2013,Kuwait,2,15,0,17
2013,Diciembre,12,12/1/2013,República de Kosovo,2,1,0,3
2013,Diciembre,12,12/1/2013,República Democrática Popular  Lao,1,0,0,1
2013,Diciembre,12,12/1/2013,Letonia,7,5,0,12
2013,Diciembre,12,12/1/2013,Lituania,22,22,0,44
2013,Diciembre,12,12/1/2013,Líbano,15,27,0,42
2013,Diciembre,12,12/1/2013,Liberia,1,2,0,3
2013,Diciembre,12,12/1/2013,Libia,0,2,0,2
2013,Diciembre,12,12/1/2013,Liechtenstein,1,6,0,7
2013,Diciembre,12,12/1/2013,Luxemburgo,5,9,0,14
2013,Diciembre,12,12/1/2013,Macedonia,0,2,0,2
2013,Diciembre,12,12/1/2013,Malasia,22,29,0,51
2013,Diciembre,12,12/1/2013,Malta,4,6,0,10
2013,Diciembre,12,12/1/2013,Marruecos,9,9,0,18
2013,Diciembre,12,12/1/2013,Mauricio,0,2,0,2
2013,Diciembre,12,12/1/2013,Mauritania,0,4,0,4
2013,Diciembre,12,12/1/2013,México,3321,5897,0,9218
2013,Diciembre,12,12/1/2013,República de Moldavia,2,0,0,2
2013,Diciembre,12,12/1/2013,Mónaco,3,2,0,5
2013,Diciembre,12,12/1/2013,Mongolia,0,1,0,1
2013,Diciembre,12,12/1/2013,Montenegro,2,5,0,7
2013,Diciembre,12,12/1/2013,Mozambique,3,1,0,4
2013,Diciembre,12,12/1/2013,Myanmar,0,53,0,53
2013,Diciembre,12,12/1/2013,Nepal,0,4,0,4
2013,Diciembre,12,12/1/2013,Nicaragua,62,104,0,166
2013,Diciembre,12,12/1/2013,Nigeria,4,11,0,15
2013,Diciembre,12,12/1/2013,Noruega,186,264,0,450
2013,Diciembre,12,12/1/2013,Nueva Zelanda,75,125,0,200
2013,Diciembre,12,12/1/2013,Pakistán,2,11,0,13
2013,Diciembre,12,12/1/2013,Panamá,1311,2071,0,3382
2013,Diciembre,12,12/1/2013,Paraguay,122,107,0,229
2013,Diciembre,12,12/1/2013,Perú,3003,4232,0,7235
2013,Diciembre,12,12/1/2013,Palestina,0,1,0,1
2013,Diciembre,12,12/1/2013,Polonia,88,168,0,256
2013,Diciembre,12,12/1/2013,Portugal,126,402,0,528
2013,Diciembre,12,12/1/2013,Puerto Rico/Territorio de Estados Unidos,2,1,0,3
2013,Diciembre,12,12/1/2013,Qatar,0,4,0,4
2013,Diciembre,12,12/1/2013,Reino Unido de Gran Bretaña e Irlanda del Norte,948,2043,0,2991
2013,Diciembre,12,12/1/2013,República CentroÁfricana,0,1,0,1
2013,Diciembre,12,12/1/2013,Federación de Rusia,167,216,0,383
2013,Diciembre,12,12/1/2013,República Dominicana,323,482,0,805
2013,Diciembre,12,12/1/2013,Rumania,57,96,0,153
2013,Diciembre,12,12/1/2013,Rwanda,0,1,0,1
2013,Diciembre,12,12/1/2013,San Cristóbal y Nevis,1,1,0,2
2013,Diciembre,12,12/1/2013,Santa Lucia,3,8,0,11
2013,Diciembre,12,12/1/2013,Santa Sede/Ciudad del Vaticano,0,1,0,1
2013,Diciembre,12,12/1/2013,Senegal,0,2,0,2
2013,Diciembre,12,12/1/2013,Serbia,11,5,0,16
2013,Diciembre,12,12/1/2013,Singapur,15,32,0,47
2013,Diciembre,12,12/1/2013,República Árabe Siria,1,3,0,4
2013,Diciembre,12,12/1/2013,Somalia,1,0,0,1
2013,Diciembre,12,12/1/2013,Sri Lanka,1,5,0,6
2013,Diciembre,12,12/1/2013,Sudáfrica,42,59,0,101
2013,Diciembre,12,12/1/2013,Sudán,0,2,0,2
2013,Diciembre,12,12/1/2013,Suecia,389,610,0,999
2013,Diciembre,12,12/1/2013,Suiza,522,960,0,1482
2013,Diciembre,12,12/1/2013,Surinam,43,43,0,86
2013,Diciembre,12,12/1/2013,Taiwán,51,62,0,113
2013,Diciembre,12,12/1/2013,Tailandia,7,5,0,12
2013,Diciembre,12,12/1/2013,Tanzania,3,0,0,3
2013,Diciembre,12,12/1/2013,Tonga,0,5,0,5
2013,Diciembre,12,12/1/2013,Trinidad y Tobago,33,82,0,115
2013,Diciembre,12,12/1/2013,Túnez,0,2,0,2
2013,Diciembre,12,12/1/2013,Turkmenistán,1,0,0,1
2013,Diciembre,12,12/1/2013,Turquía,24,79,0,103
2013,Diciembre,12,12/1/2013,Tuvalu,0,4,0,4
2013,Diciembre,12,12/1/2013,Ucrania,21,46,0,67
2013,Diciembre,12,12/1/2013,Uganda,4,8,0,12
2013,Diciembre,12,12/1/2013,Uruguay,222,383,0,605
2013,Diciembre,12,12/1/2013,Uzbekistán,1,1,0,2
2013,Diciembre,12,12/1/2013,Venezuela,14365,17166,0,31531
2013,Diciembre,12,12/1/2013,Vietnam,2,1,0,3
2013,Diciembre,12,12/1/2013,República Árabe de Yemen,0,1,0,1
2013,Diciembre,12,12/1/2013,Zambia,0,2,0,2
2013,Diciembre,12,12/1/2013,Zimbabue,1,1,0,2
2013,Diciembre,12,12/1/2013,Anguila/Territorio Británico de Ultramar,0,1,0,1
2013,Diciembre,12,12/1/2013,Desconocido,31,87,0,118
2014,Enero,1,1/1/2014,Albania,2,4,0,6
2014,Enero,1,1/1/2014,Alemania,1671,2469,0,4140
2014,Enero,1,1/1/2014,Andorra,1,8,0,9
2014,Enero,1,1/1/2014,Angola,0,1,0,1
2014,Enero,1,1/1/2014,Antigua y Barbuda,0,2,0,2
2014,Enero,1,1/1/2014,Países Bajos,942,1601,0,2543
2014,Enero,1,1/1/2014,Arabia Saudita,0,7,0,7
2014,Enero,1,1/1/2014,Argelia,1,6,0,7
2014,Enero,1,1/1/2014,Argentina,7105,7129,0,14234
2014,Enero,1,1/1/2014,República de Armenia,2,0,0,2
2014,Enero,1,1/1/2014,Aruba,0,1,0,1
2014,Enero,1,1/1/2014,Australia,381,624,0,1005
2014,Enero,1,1/1/2014,Austria,152,285,0,437
2014,Enero,1,1/1/2014,Bahamas,5,10,0,15
2014,Enero,1,1/1/2014,Bahréin,0,1,0,1
2014,Enero,1,1/1/2014,Bangladesh,0,4,0,4
2014,Enero,1,1/1/2014,Barbados,12,5,0,17
2014,Enero,1,1/1/2014,República de Belarús,5,2,0,7
2014,Enero,1,1/1/2014,Bélgica,199,419,0,618
2014,Enero,1,1/1/2014,Belice,3,3,0,6
2014,Enero,1,1/1/2014,Benín,1,0,0,1
2014,Enero,1,1/1/2014,Bermudas/Territorio Británico de Ultramar,0,1,0,1
2014,Enero,1,1/1/2014,Bolivia,651,778,0,1429
2014,Enero,1,1/1/2014,Bosnia y Herzegovina,1,1,0,2
2014,Enero,1,1/1/2014,Brasil,4639,5423,0,10062
2014,Enero,1,1/1/2014,Bulgaria,20,13,0,33
2014,Enero,1,1/1/2014,Burkina Faso,1,0,0,1
2014,Enero,1,1/1/2014,Burundi,0,7,0,7
2014,Enero,1,1/1/2014,Cabo Verde,0,1,0,1
2014,Enero,1,1/1/2014,Islas Caimán/Territorio Británico de Ultramar,3,1,0,4
2014,Enero,1,1/1/2014,Canadá,2372,3208,0,5580
2014,Enero,1,1/1/2014,Chad,0,1,0,1
2014,Enero,1,1/1/2014,España,2690,6398,0,9088
2014,Enero,1,1/1/2014,República Democrática del Congo,4,11,0,15
2014,Enero,1,1/1/2014,República de Corea,246,426,0,672
2014,Enero,1,1/1/2014,Costa de Marfil,0,2,0,2
2014,Enero,1,1/1/2014,Costa Rica,1308,1406,0,2714
2014,Enero,1,1/1/2014,Croacia,10,48,0,58
2014,Enero,1,1/1/2014,Cuba,157,267,0,424
2014,Enero,1,1/1/2014,República Checa,40,86,0,126
2014,Enero,1,1/1/2014,Chile,3423,3972,0,7395
2014,Enero,1,1/1/2014,China,148,292,0,440
2014,Enero,1,1/1/2014,Chipre,2,5,0,7
2014,Enero,1,1/1/2014,Dinamarca,101,182,0,283
2014,Enero,1,1/1/2014,Dominica,2,4,0,6
2014,Enero,1,1/1/2014,Ecuador,3356,5351,0,8707
2014,Enero,1,1/1/2014,Egipto,4,13,0,17
2014,Enero,1,1/1/2014,El Salvador,548,834,0,1382
2014,Enero,1,1/1/2014,Emiratos Árabes,0,1,0,1
2014,Enero,1,1/1/2014,Eslovaquia,15,34,0,49
2014,Enero,1,1/1/2014,Eslovenia,27,30,0,57
2014,Enero,1,1/1/2014,Estados Unidos de América,8359,16436,0,24795
2014,Enero,1,1/1/2014,Estonia,10,10,0,20
2014,Enero,1,1/1/2014,Etiopia,0,1,0,1
2014,Enero,1,1/1/2014,Filipinas,26,125,0,151
2014,Enero,1,1/1/2014,Finlandia,68,101,0,169
2014,Enero,1,1/1/2014,Francia,1641,2517,0,4158
2014,Enero,1,1/1/2014,Georgia,3,1,0,4
2014,Enero,1,1/1/2014,Ghana,1,2,0,3
2014,Enero,1,1/1/2014,Granada,0,1,0,1
2014,Enero,1,1/1/2014,Grecia,22,91,0,113
2014,Enero,1,1/1/2014,Guatemala,320,663,0,983
2014,Enero,1,1/1/2014,Guyana,7,14,0,21
2014,Enero,1,1/1/2014,Guinea Ecuatorial,1,0,0,1
2014,Enero,1,1/1/2014,Haití,16,19,0,35
2014,Enero,1,1/1/2014,Honduras,172,285,0,457
2014,Enero,1,1/1/2014,Hong Kong,0,1,0,1
2014,Enero,1,1/1/2014,Hungría,30,50,0,80
2014,Enero,1,1/1/2014,India,62,300,0,362
2014,Enero,1,1/1/2014,Indonesia,5,20,0,25
2014,Enero,1,1/1/2014,Irán,4,8,0,12
2014,Enero,1,1/1/2014,República de Irlanda,76,191,0,267
2014,Enero,1,1/1/2014,Islandia,10,10,0,20
2014,Enero,1,1/1/2014,Israel,80,493,0,573
2014,Enero,1,1/1/2014,Italia,754,2334,0,3088
2014,Enero,1,1/1/2014,Jamaica,18,31,0,49
2014,Enero,1,1/1/2014,Islas Salomón,1,0,0,1
2014,Enero,1,1/1/2014,Japón,155,477,0,632
2014,Enero,1,1/1/2014,Jordania,0,4,0,4
2014,Enero,1,1/1/2014,Kazajistán,0,2,0,2
2014,Enero,1,1/1/2014,Kenia,1,2,0,3
2014,Enero,1,1/1/2014,Kuwait,0,2,0,2
2014,Enero,1,1/1/2014,República de Kosovo,1,1,0,2
2014,Enero,1,1/1/2014,Letonia,12,30,0,42
2014,Enero,1,1/1/2014,Lituania,15,11,0,26
2014,Enero,1,1/1/2014,Líbano,12,24,0,36
2014,Enero,1,1/1/2014,Liechtenstein,1,1,0,2
2014,Enero,1,1/1/2014,Luxemburgo,3,13,0,16
2014,Enero,1,1/1/2014,Macedonia,2,0,0,2
2014,Enero,1,1/1/2014,Madagascar,3,1,0,4
2014,Enero,1,1/1/2014,Malasia,9,11,0,20
2014,Enero,1,1/1/2014,Malí,0,1,0,1
2014,Enero,1,1/1/2014,Malta,5,10,0,15
2014,Enero,1,1/1/2014,Marruecos,4,15,0,19
2014,Enero,1,1/1/2014,Mauricio,0,1,0,1
2014,Enero,1,1/1/2014,México,2715,5442,0,8157
2014,Enero,1,1/1/2014,República de Moldavia,4,3,0,7
2014,Enero,1,1/1/2014,Mónaco,1,1,0,2
2014,Enero,1,1/1/2014,Mongolia,1,0,0,1
2014,Enero,1,1/1/2014,Montenegro,1,4,0,5
2014,Enero,1,1/1/2014,Nepal,0,1,0,1
2014,Enero,1,1/1/2014,Nicaragua,95,122,0,217
2014,Enero,1,1/1/2014,Nigeria,0,8,0,8
2014,Enero,1,1/1/2014,Noruega,124,206,0,330
2014,Enero,1,1/1/2014,Nueva Zelanda,62,87,0,149
2014,Enero,1,1/1/2014,Pakistán,3,21,0,24
2014,Enero,1,1/1/2014,Panamá,1157,1611,0,2768
2014,Enero,1,1/1/2014,Paraguay,142,151,0,293
2014,Enero,1,1/1/2014,Perú,3769,4807,0,8576
2014,Enero,1,1/1/2014,Palestina,1,5,0,6
2014,Enero,1,1/1/2014,Polonia,159,192,0,351
2014,Enero,1,1/1/2014,Portugal,182,481,0,663
2014,Enero,1,1/1/2014,Qatar,0,2,0,2
2014,Enero,1,1/1/2014,Reino Unido de Gran Bretaña e Irlanda del Norte,814,1819,0,2633
2014,Enero,1,1/1/2014,República CentroÁfricana,5,0,0,5
2014,Enero,1,1/1/2014,Federación de Rusia,400,497,0,897
2014,Enero,1,1/1/2014,República Dominicana,280,570,0,850
2014,Enero,1,1/1/2014,República Democrática Popular de Corea,0,1,0,1
2014,Enero,1,1/1/2014,Rumania,58,82,0,140
2014,Enero,1,1/1/2014,Rwanda,1,1,0,2
2014,Enero,1,1/1/2014,San Cristóbal y Nevis,1,2,0,3
2014,Enero,1,1/1/2014,Samoa Estadounidense/Territorio no incorporado de Estados Unidos,0,1,0,1
2014,Enero,1,1/1/2014,San Marino,0,1,0,1
2014,Enero,1,1/1/2014,San  Vicente y las Granadinas,1,2,0,3
2014,Enero,1,1/1/2014,Santa Lucia,1,1,0,2
2014,Enero,1,1/1/2014,Santa Sede/Ciudad del Vaticano,0,2,0,2
2014,Enero,1,1/1/2014,Senegal,1,0,0,1
2014,Enero,1,1/1/2014,Serbia,10,11,0,21
2014,Enero,1,1/1/2014,Singapur,11,22,0,33
2014,Enero,1,1/1/2014,República Árabe Siria,1,3,0,4
2014,Enero,1,1/1/2014,Somalia,1,1,0,2
2014,Enero,1,1/1/2014,Sri Lanka,1,3,0,4
2014,Enero,1,1/1/2014,Sudáfrica,31,66,0,97
2014,Enero,1,1/1/2014,Suecia,279,446,0,725
2014,Enero,1,1/1/2014,Suiza,413,729,0,1142
2014,Enero,1,1/1/2014,Surinam,29,29,0,58
2014,Enero,1,1/1/2014,Taiwán,38,58,0,96
2014,Enero,1,1/1/2014,Tailandia,1,3,0,4
2014,Enero,1,1/1/2014,Tanzania,3,3,0,6
2014,Enero,1,1/1/2014,Togo,0,3,0,3
2014,Enero,1,1/1/2014,Trinidad y Tobago,24,58,0,82
2014,Enero,1,1/1/2014,Túnez,1,1,0,2
2014,Enero,1,1/1/2014,Turquía,42,134,0,176
2014,Enero,1,1/1/2014,Ucrania,33,40,0,73
2014,Enero,1,1/1/2014,Uganda,1,0,0,1
2014,Enero,1,1/1/2014,Uruguay,262,413,0,675
2014,Enero,1,1/1/2014,Uzbekistán,1,0,0,1
2014,Enero,1,1/1/2014,Venezuela,11261,13401,0,24662
2014,Enero,1,1/1/2014,Vietnam,2,2,0,4
2014,Enero,1,1/1/2014,Zambia,0,1,0,1
2014,Enero,1,1/1/2014,Zimbabue,3,1,0,4
2014,Enero,1,1/1/2014,Desconocido,36,50,0,86
2014,Febrero,2,2/1/2014,Afganistán,0,2,0,2
2014,Febrero,2,2/1/2014,Albania,1,7,0,8
2014,Febrero,2,2/1/2014,Alemania,1784,2712,0,4496
2014,Febrero,2,2/1/2014,Andorra,8,9,0,17
2014,Febrero,2,2/1/2014,Antigua y Barbuda,1,2,0,3
2014,Febrero,2,2/1/2014,Países Bajos,979,1572,0,2551
2014,Febrero,2,2/1/2014,Arabia Saudita,1,1,0,2
2014,Febrero,2,2/1/2014,Argelia,2,3,0,5
2014,Febrero,2,2/1/2014,Argentina,5134,6170,0,11304
2014,Febrero,2,2/1/2014,República de Armenia,0,1,0,1
2014,Febrero,2,2/1/2014,Aruba,0,1,0,1
2014,Febrero,2,2/1/2014,Australia,273,571,0,844
2014,Febrero,2,2/1/2014,Austria,175,296,0,471
2014,Febrero,2,2/1/2014,Azerbaiyán,1,0,0,1
2014,Febrero,2,2/1/2014,Bahamas,3,12,0,15
2014,Febrero,2,2/1/2014,Bahréin,0,1,0,1
2014,Febrero,2,2/1/2014,Bangladesh,1,5,0,6
2014,Febrero,2,2/1/2014,Barbados,4,7,0,11
2014,Febrero,2,2/1/2014,República de Belarús,9,20,0,29
2014,Febrero,2,2/1/2014,Bélgica,169,419,0,588
2014,Febrero,2,2/1/2014,Belice,2,8,0,10
2014,Febrero,2,2/1/2014,Benín,1,1,0,2
2014,Febrero,2,2/1/2014,Bermudas/Territorio Británico de Ultramar,1,3,0,4
2014,Febrero,2,2/1/2014,Bolivia,310,473,0,783
2014,Febrero,2,2/1/2014,Bosnia y Herzegovina,0,1,0,1
2014,Febrero,2,2/1/2014,Botsuana,1,0,0,1
2014,Febrero,2,2/1/2014,Brasil,3901,5026,0,8927
2014,Febrero,2,2/1/2014,Bulgaria,33,22,0,55
2014,Febrero,2,2/1/2014,Islas Caimán/Territorio Británico de Ultramar,2,4,0,6
2014,Febrero,2,2/1/2014,Camboya,0,5,0,5
2014,Febrero,2,2/1/2014,Canadá,2227,3129,0,5356
2014,Febrero,2,2/1/2014,España,2206,5604,0,7810
2014,Febrero,2,2/1/2014,República Democrática del Congo,2,0,0,2
2014,Febrero,2,2/1/2014,República de Corea,214,511,0,725
2014,Febrero,2,2/1/2014,Costa de Marfil,0,2,0,2
2014,Febrero,2,2/1/2014,Costa Rica,765,1104,0,1869
2014,Febrero,2,2/1/2014,Croacia,12,49,0,61
2014,Febrero,2,2/1/2014,Cuba,101,204,0,305
2014,Febrero,2,2/1/2014,Curazao,1,0,0,1
2014,Febrero,2,2/1/2014,República Checa,68,94,0,162
2014,Febrero,2,2/1/2014,Chile,5146,5485,0,10631
2014,Febrero,2,2/1/2014,China,190,495,0,685
2014,Febrero,2,2/1/2014,Chipre,2,4,0,6
2014,Febrero,2,2/1/2014,Dinamarca,101,237,0,338
2014,Febrero,2,2/1/2014,Dominica,1,2,0,3
2014,Febrero,2,2/1/2014,Ecuador,4038,5324,0,9362
2014,Febrero,2,2/1/2014,Egipto,6,24,0,30
2014,Febrero,2,2/1/2014,El Salvador,561,909,0,1470
2014,Febrero,2,2/1/2014,Emiratos Árabes,1,6,0,7
2014,Febrero,2,2/1/2014,Eslovaquia,19,22,0,41
2014,Febrero,2,2/1/2014,Eslovenia,23,34,0,57
2014,Febrero,2,2/1/2014,Estados Unidos de América,9764,18848,0,28612
2014,Febrero,2,2/1/2014,Estonia,6,14,0,20
2014,Febrero,2,2/1/2014,Etiopia,0,4,0,4
2014,Febrero,2,2/1/2014,Filipinas,25,172,0,197
2014,Febrero,2,2/1/2014,Finlandia,76,116,0,192
2014,Febrero,2,2/1/2014,Francia,1385,2507,0,3892
2014,Febrero,2,2/1/2014,Gabón,0,1,0,1
2014,Febrero,2,2/1/2014,Georgia,2,2,0,4
2014,Febrero,2,2/1/2014,Ghana,5,3,0,8
2014,Febrero,2,2/1/2014,Granada,1,0,0,1
2014,Febrero,2,2/1/2014,Grecia,25,94,0,119
2014,Febrero,2,2/1/2014,Guatemala,341,715,0,1056
2014,Febrero,2,2/1/2014,Guyana,2,9,0,11
2014,Febrero,2,2/1/2014,Guinea,0,2,0,2
2014,Febrero,2,2/1/2014,Guinea Bissau,0,1,0,1
2014,Febrero,2,2/1/2014,Guayana Francesa/Departamento de Ultramar Francés,1,0,0,1
2014,Febrero,2,2/1/2014,Haití,4,21,0,25
2014,Febrero,2,2/1/2014,Honduras,151,249,0,400
2014,Febrero,2,2/1/2014,Hungría,26,59,0,85
2014,Febrero,2,2/1/2014,India,59,312,0,371
2014,Febrero,2,2/1/2014,Indonesia,19,35,0,54
2014,Febrero,2,2/1/2014,Iraq,0,1,0,1
2014,Febrero,2,2/1/2014,Irán,3,11,0,14
2014,Febrero,2,2/1/2014,República de Irlanda,61,177,0,238
2014,Febrero,2,2/1/2014,Islandia,6,5,0,11
2014,Febrero,2,2/1/2014,Israel,86,547,0,633
2014,Febrero,2,2/1/2014,Italia,617,2099,0,2716
2014,Febrero,2,2/1/2014,Jamaica,14,25,0,39
2014,Febrero,2,2/1/2014,Japón,150,616,0,766
2014,Febrero,2,2/1/2014,Jordania,3,3,0,6
2014,Febrero,2,2/1/2014,Kazajistán,0,7,0,7
2014,Febrero,2,2/1/2014,Kenia,2,5,0,7
2014,Febrero,2,2/1/2014,Kirguistán,0,1,0,1
2014,Febrero,2,2/1/2014,República de Kosovo,1,0,0,1
2014,Febrero,2,2/1/2014,República Democrática Popular  Lao,3,1,0,4
2014,Febrero,2,2/1/2014,Letonia,10,45,0,55
2014,Febrero,2,2/1/2014,Lituania,15,18,0,33
2014,Febrero,2,2/1/2014,Líbano,17,32,0,49
2014,Febrero,2,2/1/2014,Liechtenstein,2,1,0,3
2014,Febrero,2,2/1/2014,Luxemburgo,4,12,0,16
2014,Febrero,2,2/1/2014,Macedonia,1,3,0,4
2014,Febrero,2,2/1/2014,Malasia,16,32,0,48
2014,Febrero,2,2/1/2014,Malawi,0,1,0,1
2014,Febrero,2,2/1/2014,Malí,0,2,0,2
2014,Febrero,2,2/1/2014,Malta,2,10,0,12
2014,Febrero,2,2/1/2014,Marruecos,4,15,0,19
2014,Febrero,2,2/1/2014,Mauricio,0,1,0,1
2014,Febrero,2,2/1/2014,Mauritania,1,1,0,2
2014,Febrero,2,2/1/2014,México,2399,5685,0,8084
2014,Febrero,2,2/1/2014,República de Moldavia,2,1,0,3
2014,Febrero,2,2/1/2014,Mónaco,0,1,0,1
2014,Febrero,2,2/1/2014,Mongolia,1,1,0,2
2014,Febrero,2,2/1/2014,Montenegro,0,2,0,2
2014,Febrero,2,2/1/2014,Myanmar,2,17,0,19
2014,Febrero,2,2/1/2014,Nepal,1,7,0,8
2014,Febrero,2,2/1/2014,Nicaragua,73,101,0,174
2014,Febrero,2,2/1/2014,Nigeria,2,11,0,13
2014,Febrero,2,2/1/2014,Noruega,120,191,0,311
2014,Febrero,2,2/1/2014,Nueva Zelanda,42,94,0,136
2014,Febrero,2,2/1/2014,Omán,1,1,0,2
2014,Febrero,2,2/1/2014,Pakistán,1,10,0,11
2014,Febrero,2,2/1/2014,Panamá,1044,1678,0,2722
2014,Febrero,2,2/1/2014,Paraguay,142,200,0,342
2014,Febrero,2,2/1/2014,Perú,4867,5473,0,10340
2014,Febrero,2,2/1/2014,Polonia,186,215,0,401
2014,Febrero,2,2/1/2014,Portugal,95,378,0,473
2014,Febrero,2,2/1/2014,Puerto Rico/Territorio de Estados Unidos,0,1,0,1
2014,Febrero,2,2/1/2014,Reino Unido de Gran Bretaña e Irlanda del Norte,859,1760,0,2619
2014,Febrero,2,2/1/2014,Federación de Rusia,246,277,0,523
2014,Febrero,2,2/1/2014,República Dominicana,335,608,0,943
2014,Febrero,2,2/1/2014,Rumania,36,60,0,96
2014,Febrero,2,2/1/2014,San Cristóbal y Nevis,0,5,0,5
2014,Febrero,2,2/1/2014,San  Vicente y las Granadinas,1,4,0,5
2014,Febrero,2,2/1/2014,Santa Lucia,7,1,0,8
2014,Febrero,2,2/1/2014,Senegal,0,1,0,1
2014,Febrero,2,2/1/2014,Serbia,3,10,0,13
2014,Febrero,2,2/1/2014,Singapur,12,18,0,30
2014,Febrero,2,2/1/2014,República Árabe Siria,0,1,0,1
2014,Febrero,2,2/1/2014,Sri Lanka,0,2,0,2
2014,Febrero,2,2/1/2014,Sudáfrica,29,74,0,103
2014,Febrero,2,2/1/2014,Sudán,0,1,0,1
2014,Febrero,2,2/1/2014,Suecia,256,373,0,629
2014,Febrero,2,2/1/2014,Suiza,439,758,0,1197
2014,Febrero,2,2/1/2014,Surinam,13,22,0,35
2014,Febrero,2,2/1/2014,Taiwán,80,102,0,182
2014,Febrero,2,2/1/2014,República de Tayikistán,1,0,0,1
2014,Febrero,2,2/1/2014,Tailandia,15,8,0,23
2014,Febrero,2,2/1/2014,Tanzania,0,1,0,1
2014,Febrero,2,2/1/2014,Togo,0,4,0,4
2014,Febrero,2,2/1/2014,Trinidad y Tobago,40,81,0,121
2014,Febrero,2,2/1/2014,Túnez,2,6,0,8
2014,Febrero,2,2/1/2014,Turkmenistán,1,0,0,1
2014,Febrero,2,2/1/2014,Turquía,36,123,0,159
2014,Febrero,2,2/1/2014,Ucrania,13,45,0,58
2014,Febrero,2,2/1/2014,Uganda,0,3,0,3
2014,Febrero,2,2/1/2014,Uruguay,323,504,0,827
2014,Febrero,2,2/1/2014,Uzbekistán,2,0,0,2
2014,Febrero,2,2/1/2014,Venezuela,7350,9848,0,17198
2014,Febrero,2,2/1/2014,Vietnam,6,14,0,20
2014,Febrero,2,2/1/2014,República Árabe de Yemen,0,1,0,1
2014,Febrero,2,2/1/2014,Zambia,0,1,0,1
2014,Febrero,2,2/1/2014,Zimbabue,3,0,0,3
2014,Febrero,2,2/1/2014,Desconocido,43,70,0,113
2014,Marzo,3,3/1/2014,Afganistán,1,4,0,5
2014,Marzo,3,3/1/2014,Albania,2,3,0,5
2014,Marzo,3,3/1/2014,Alemania,1677,2793,0,4470
2014,Marzo,3,3/1/2014,Andorra,0,8,0,8
2014,Marzo,3,3/1/2014,Angola,0,5,0,5
2014,Marzo,3,3/1/2014,Antigua y Barbuda,1,3,0,4
2014,Marzo,3,3/1/2014,Países Bajos,945,1674,0,2619
2014,Marzo,3,3/1/2014,Arabia Saudita,4,12,0,16
2014,Marzo,3,3/1/2014,Argelia,3,8,0,11
2014,Marzo,3,3/1/2014,Argentina,6130,7178,0,13308
2014,Marzo,3,3/1/2014,República de Armenia,2,2,0,4
2014,Marzo,3,3/1/2014,Aruba,0,1,0,1
2014,Marzo,3,3/1/2014,Australia,309,554,0,863
2014,Marzo,3,3/1/2014,Austria,114,276,0,390
2014,Marzo,3,3/1/2014,Azerbaiyán,2,5,0,7
2014,Marzo,3,3/1/2014,Bahamas,2,9,0,11
2014,Marzo,3,3/1/2014,Bahréin,0,1,0,1
2014,Marzo,3,3/1/2014,Bangladesh,2,3,0,5
2014,Marzo,3,3/1/2014,Barbados,11,6,0,17
2014,Marzo,3,3/1/2014,República de Belarús,1,3,0,4
2014,Marzo,3,3/1/2014,Bélgica,173,369,0,542
2014,Marzo,3,3/1/2014,Belice,2,9,0,11
2014,Marzo,3,3/1/2014,Benín,1,6,0,7
2014,Marzo,3,3/1/2014,Bermudas/Territorio Británico de Ultramar,0,2,0,2
2014,Marzo,3,3/1/2014,Bolivia,324,533,0,857
2014,Marzo,3,3/1/2014,Bosnia y Herzegovina,1,0,0,1
2014,Marzo,3,3/1/2014,Botsuana,1,0,0,1
2014,Marzo,3,3/1/2014,Brasil,4242,5914,0,10156
2014,Marzo,3,3/1/2014,Bulgaria,24,18,0,42
2014,Marzo,3,3/1/2014,Burundi,0,1,0,1
2014,Marzo,3,3/1/2014,Cabo Verde,0,5,0,5
2014,Marzo,3,3/1/2014,Islas Caimán/Territorio Británico de Ultramar,0,3,0,3
2014,Marzo,3,3/1/2014,Camerún,0,2,0,2
2014,Marzo,3,3/1/2014,Canadá,1949,2785,0,4734
2014,Marzo,3,3/1/2014,España,2304,6313,0,8617
2014,Marzo,3,3/1/2014,República Del Congo,0,1,0,1
2014,Marzo,3,3/1/2014,República Democrática del Congo,3,0,0,3
2014,Marzo,3,3/1/2014,República de Corea,176,519,0,695
2014,Marzo,3,3/1/2014,Costa de Marfil,1,2,0,3
2014,Marzo,3,3/1/2014,Costa Rica,669,1148,0,1817
2014,Marzo,3,3/1/2014,Croacia,11,55,0,66
2014,Marzo,3,3/1/2014,Cuba,123,244,0,367
2014,Marzo,3,3/1/2014,República Checa,56,87,0,143
2014,Marzo,3,3/1/2014,Chile,4163,5317,0,9480
2014,Marzo,3,3/1/2014,China,186,572,0,758
2014,Marzo,3,3/1/2014,Chipre,4,5,0,9
2014,Marzo,3,3/1/2014,Dinamarca,72,195,0,267
2014,Marzo,3,3/1/2014,Dominica,3,4,0,7
2014,Marzo,3,3/1/2014,Ecuador,4479,6520,0,10999
2014,Marzo,3,3/1/2014,Egipto,5,16,0,21
2014,Marzo,3,3/1/2014,El Salvador,557,848,0,1405
2014,Marzo,3,3/1/2014,Emiratos Árabes,3,3,0,6
2014,Marzo,3,3/1/2014,Eslovaquia,19,26,0,45
2014,Marzo,3,3/1/2014,Eslovenia,6,31,0,37
2014,Marzo,3,3/1/2014,Estados Unidos de América,10753,20092,0,30845
2014,Marzo,3,3/1/2014,Estonia,10,14,0,24
2014,Marzo,3,3/1/2014,Etiopia,0,2,0,2
2014,Marzo,3,3/1/2014,Filipinas,24,148,0,172
2014,Marzo,3,3/1/2014,Finlandia,47,103,0,150
2014,Marzo,3,3/1/2014,Francia,1216,2304,0,3520
2014,Marzo,3,3/1/2014,Georgia,1,2,0,3
2014,Marzo,3,3/1/2014,Ghana,0,2,0,2
2014,Marzo,3,3/1/2014,Grecia,23,86,0,109
2014,Marzo,3,3/1/2014,Guatemala,331,766,0,1097
2014,Marzo,3,3/1/2014,Guyana,5,13,0,18
2014,Marzo,3,3/1/2014,Guinea,0,1,0,1
2014,Marzo,3,3/1/2014,Guinea Bissau,1,3,0,4
2014,Marzo,3,3/1/2014,Haití,27,23,0,50
2014,Marzo,3,3/1/2014,Honduras,183,308,0,491
2014,Marzo,3,3/1/2014,Hungría,26,55,0,81
2014,Marzo,3,3/1/2014,India,66,366,0,432
2014,Marzo,3,3/1/2014,Indonesia,9,20,0,29
2014,Marzo,3,3/1/2014,Irán,6,17,0,23
2014,Marzo,3,3/1/2014,República de Irlanda,77,175,0,252
2014,Marzo,3,3/1/2014,Islandia,1,13,0,14
2014,Marzo,3,3/1/2014,Israel,122,721,0,843
2014,Marzo,3,3/1/2014,Italia,540,2039,0,2579
2014,Marzo,3,3/1/2014,Jamaica,31,38,0,69
2014,Marzo,3,3/1/2014,Japón,172,552,0,724
2014,Marzo,3,3/1/2014,Jordania,0,2,0,2
2014,Marzo,3,3/1/2014,Kazajistán,4,1,0,5
2014,Marzo,3,3/1/2014,Kenia,4,9,0,13
2014,Marzo,3,3/1/2014,Kirguistán,0,1,0,1
2014,Marzo,3,3/1/2014,Kuwait,0,1,0,1
2014,Marzo,3,3/1/2014,República de Kosovo,1,1,0,2
2014,Marzo,3,3/1/2014,Letonia,12,9,0,21
2014,Marzo,3,3/1/2014,Lituania,16,28,0,44
2014,Marzo,3,3/1/2014,Líbano,17,23,0,40
2014,Marzo,3,3/1/2014,Liberia,0,3,0,3
2014,Marzo,3,3/1/2014,Liechtenstein,1,1,0,2
2014,Marzo,3,3/1/2014,Luxemburgo,2,8,0,10
2014,Marzo,3,3/1/2014,Macedonia,0,4,0,4
2014,Marzo,3,3/1/2014,Madagascar,3,0,0,3
2014,Marzo,3,3/1/2014,Malasia,13,30,0,43
2014,Marzo,3,3/1/2014,Malí,1,2,0,3
2014,Marzo,3,3/1/2014,Malta,2,4,0,6
2014,Marzo,3,3/1/2014,Marruecos,1,7,0,8
2014,Marzo,3,3/1/2014,México,2547,6322,0,8869
2014,Marzo,3,3/1/2014,República de Moldavia,3,3,0,6
2014,Marzo,3,3/1/2014,Mónaco,1,2,0,3
2014,Marzo,3,3/1/2014,Mongolia,1,0,0,1
2014,Marzo,3,3/1/2014,Montenegro,0,2,0,2
2014,Marzo,3,3/1/2014,Namibia,1,0,0,1
2014,Marzo,3,3/1/2014,Nepal,1,2,0,3
2014,Marzo,3,3/1/2014,Nicaragua,79,109,0,188
2014,Marzo,3,3/1/2014,Nigeria,6,16,0,22
2014,Marzo,3,3/1/2014,Noruega,74,147,0,221
2014,Marzo,3,3/1/2014,Nueva Zelanda,59,122,0,181
2014,Marzo,3,3/1/2014,Omán,1,1,0,2
2014,Marzo,3,3/1/2014,Pakistán,3,8,0,11
2014,Marzo,3,3/1/2014,Panamá,1055,1602,0,2657
2014,Marzo,3,3/1/2014,Paraguay,179,197,0,376
2014,Marzo,3,3/1/2014,Perú,4558,5698,0,10256
2014,Marzo,3,3/1/2014,Polonia,116,151,0,267
2014,Marzo,3,3/1/2014,Portugal,140,409,0,549
2014,Marzo,3,3/1/2014,Reino Unido de Gran Bretaña e Irlanda del Norte,768,1779,0,2547
2014,Marzo,3,3/1/2014,Federación de Rusia,228,275,0,503
2014,Marzo,3,3/1/2014,República Dominicana,342,596,0,938
2014,Marzo,3,3/1/2014,Rumania,41,75,0,116
2014,Marzo,3,3/1/2014,San Cristóbal y Nevis,2,1,0,3
2014,Marzo,3,3/1/2014,San  Vicente y las Granadinas,1,1,0,2
2014,Marzo,3,3/1/2014,Santa Lucia,1,3,0,4
2014,Marzo,3,3/1/2014,Senegal,0,2,0,2
2014,Marzo,3,3/1/2014,Serbia,4,22,0,26
2014,Marzo,3,3/1/2014,Singapur,6,28,0,34
2014,Marzo,3,3/1/2014,República Árabe Siria,0,4,0,4
2014,Marzo,3,3/1/2014,Sri Lanka,1,1,0,2
2014,Marzo,3,3/1/2014,Sudáfrica,29,91,0,120
2014,Marzo,3,3/1/2014,Suecia,197,307,0,504
2014,Marzo,3,3/1/2014,Suiza,340,678,0,1018
2014,Marzo,3,3/1/2014,Surinam,22,55,0,77
2014,Marzo,3,3/1/2014,Taiwán,73,121,0,194
2014,Marzo,3,3/1/2014,Tailandia,6,4,0,10
2014,Marzo,3,3/1/2014,Tanzania,2,0,0,2
2014,Marzo,3,3/1/2014,Trinidad y Tobago,21,71,0,92
2014,Marzo,3,3/1/2014,Túnez,0,2,0,2
2014,Marzo,3,3/1/2014,Turquía,34,158,0,192
2014,Marzo,3,3/1/2014,Ucrania,16,48,0,64
2014,Marzo,3,3/1/2014,Uganda,1,3,0,4
2014,Marzo,3,3/1/2014,Uruguay,385,539,0,924
2014,Marzo,3,3/1/2014,Uzbekistán,2,0,0,2
2014,Marzo,3,3/1/2014,Venezuela,6204,9247,0,15451
2014,Marzo,3,3/1/2014,Vietnam,1,3,0,4
2014,Marzo,3,3/1/2014,República Árabe de Yemen,0,1,0,1
2014,Marzo,3,3/1/2014,Zambia,0,1,0,1
2014,Marzo,3,3/1/2014,Desconocido,63,102,0,165
2014,Abril,4,4/1/2014,Afganistán,1,7,0,8
2014,Abril,4,4/1/2014,Albania,2,2,0,4
2014,Abril,4,4/1/2014,Alemania,1595,2319,0,3914
2014,Abril,4,4/1/2014,Andorra,1,9,0,10
2014,Abril,4,4/1/2014,Angola,7,30,0,37
2014,Abril,4,4/1/2014,Antigua y Barbuda,1,1,0,2
2014,Abril,4,4/1/2014,Países Bajos,1095,1582,0,2677
2014,Abril,4,4/1/2014,Arabia Saudita,1,23,0,24
2014,Abril,4,4/1/2014,Argelia,1,6,0,7
2014,Abril,4,4/1/2014,Argentina,4134,5170,0,9304
2014,Abril,4,4/1/2014,República de Armenia,1,2,0,3
2014,Abril,4,4/1/2014,Australia,348,593,0,941
2014,Abril,4,4/1/2014,Austria,111,205,0,316
2014,Abril,4,4/1/2014,Azerbaiyán,1,2,0,3
2014,Abril,4,4/1/2014,Bahamas,4,23,0,27
2014,Abril,4,4/1/2014,Bahréin,1,2,0,3
2014,Abril,4,4/1/2014,Bangladesh,2,17,0,19
2014,Abril,4,4/1/2014,Barbados,4,5,0,9
2014,Abril,4,4/1/2014,República de Belarús,2,2,0,4
2014,Abril,4,4/1/2014,Bélgica,157,360,0,517
2014,Abril,4,4/1/2014,Belice,5,9,0,14
2014,Abril,4,4/1/2014,Benín,0,3,0,3
2014,Abril,4,4/1/2014,Bolivia,305,407,0,712
2014,Abril,4,4/1/2014,Bosnia y Herzegovina,2,2,0,4
2014,Abril,4,4/1/2014,Botsuana,6,7,0,13
2014,Abril,4,4/1/2014,Brasil,4353,5560,0,9913
2014,Abril,4,4/1/2014,Brunei Darussalam,0,1,0,1
2014,Abril,4,4/1/2014,Bulgaria,21,31,0,52
2014,Abril,4,4/1/2014,Burkina Faso,3,3,0,6
2014,Abril,4,4/1/2014,Burundi,3,9,0,12
2014,Abril,4,4/1/2014,Bután,2,5,0,7
2014,Abril,4,4/1/2014,Cabo Verde,1,0,0,1
2014,Abril,4,4/1/2014,Islas Caimán/Territorio Británico de Ultramar,7,20,0,27
2014,Abril,4,4/1/2014,Camboya,0,1,0,1
2014,Abril,4,4/1/2014,Camerún,7,24,0,31
2014,Abril,4,4/1/2014,Canadá,934,1680,0,2614
2014,Abril,4,4/1/2014,Chad,2,9,0,11
2014,Abril,4,4/1/2014,España,2539,5680,0,8219
2014,Abril,4,4/1/2014,República Del Congo,1,1,0,2
2014,Abril,4,4/1/2014,República Democrática del Congo,1,6,0,7
2014,Abril,4,4/1/2014,República de Corea,184,475,0,659
2014,Abril,4,4/1/2014,Costa de Marfil,1,4,0,5
2014,Abril,4,4/1/2014,Costa Rica,913,1279,0,2192
2014,Abril,4,4/1/2014,Croacia,18,90,0,108
2014,Abril,4,4/1/2014,Cuba,131,273,0,404
2014,Abril,4,4/1/2014,República Checa,30,45,0,75
2014,Abril,4,4/1/2014,Chile,3034,4078,0,7112
2014,Abril,4,4/1/2014,China,251,692,0,943
2014,Abril,4,4/1/2014,Chipre,0,5,0,5
2014,Abril,4,4/1/2014,Dinamarca,92,153,0,245
2014,Abril,4,4/1/2014,Dominica,0,5,0,5
2014,Abril,4,4/1/2014,Ecuador,4632,6116,0,10748
2014,Abril,4,4/1/2014,Egipto,10,25,0,35
2014,Abril,4,4/1/2014,El Salvador,545,720,0,1265
2014,Abril,4,4/1/2014,Emiratos Árabes,2,9,0,11
2014,Abril,4,4/1/2014,Eritrea,0,2,0,2
2014,Abril,4,4/1/2014,Eslovaquia,20,29,0,49
2014,Abril,4,4/1/2014,Eslovenia,23,42,0,65
2014,Abril,4,4/1/2014,Estados Unidos de América,8600,16390,0,24990
2014,Abril,4,4/1/2014,Estonia,5,6,0,11
2014,Abril,4,4/1/2014,Etiopia,6,23,0,29
2014,Abril,4,4/1/2014,Islas Fiji,1,3,0,4
2014,Abril,4,4/1/2014,Filipinas,33,202,0,235
2014,Abril,4,4/1/2014,Finlandia,53,104,0,157
2014,Abril,4,4/1/2014,Francia,1316,2234,0,3550
2014,Abril,4,4/1/2014,Gabón,0,1,0,1
2014,Abril,4,4/1/2014,Gambia,1,13,0,14
2014,Abril,4,4/1/2014,Georgia,1,2,0,3
2014,Abril,4,4/1/2014,Ghana,17,56,0,73
2014,Abril,4,4/1/2014,Granada,1,2,0,3
2014,Abril,4,4/1/2014,Grecia,26,90,0,116
2014,Abril,4,4/1/2014,Guatemala,439,847,0,1286
2014,Abril,4,4/1/2014,Guyana,9,12,0,21
2014,Abril,4,4/1/2014,Haití,12,28,0,40
2014,Abril,4,4/1/2014,Honduras,216,338,0,554
2014,Abril,4,4/1/2014,Hungría,22,40,0,62
2014,Abril,4,4/1/2014,India,48,294,0,342
2014,Abril,4,4/1/2014,Indonesia,18,43,0,61
2014,Abril,4,4/1/2014,Iraq,0,8,0,8
2014,Abril,4,4/1/2014,Irán,6,20,0,26
2014,Abril,4,4/1/2014,República de Irlanda,85,157,0,242
2014,Abril,4,4/1/2014,Islandia,4,7,0,11
2014,Abril,4,4/1/2014,Israel,181,692,0,873
2014,Abril,4,4/1/2014,Italia,564,1639,0,2203
2014,Abril,4,4/1/2014,Jamaica,13,42,0,55
2014,Abril,4,4/1/2014,Japón,153,532,0,685
2014,Abril,4,4/1/2014,Jordania,6,11,0,17
2014,Abril,4,4/1/2014,Kazajistán,3,2,0,5
2014,Abril,4,4/1/2014,Kenia,33,56,0,89
2014,Abril,4,4/1/2014,Kiribati,2,0,0,2
2014,Abril,4,4/1/2014,Kuwait,3,5,0,8
2014,Abril,4,4/1/2014,República de Kosovo,2,1,0,3
2014,Abril,4,4/1/2014,República Democrática Popular  Lao,1,0,0,1
2014,Abril,4,4/1/2014,Lesoto,8,2,0,10
2014,Abril,4,4/1/2014,Letonia,5,9,0,14
2014,Abril,4,4/1/2014,Lituania,13,18,0,31
2014,Abril,4,4/1/2014,Líbano,15,44,0,59
2014,Abril,4,4/1/2014,Liberia,1,0,0,1
2014,Abril,4,4/1/2014,Libia,0,12,0,12
2014,Abril,4,4/1/2014,Liechtenstein,3,1,0,4
2014,Abril,4,4/1/2014,Luxemburgo,8,9,0,17
2014,Abril,4,4/1/2014,Macedonia,0,1,0,1
2014,Abril,4,4/1/2014,Madagascar,4,1,0,5
2014,Abril,4,4/1/2014,Malasia,24,41,0,65
2014,Abril,4,4/1/2014,Malawi,2,4,0,6
2014,Abril,4,4/1/2014,Maldivas,2,0,0,2
2014,Abril,4,4/1/2014,Malí,0,4,0,4
2014,Abril,4,4/1/2014,Malta,5,5,0,10
2014,Abril,4,4/1/2014,Marruecos,7,14,0,21
2014,Abril,4,4/1/2014,Islas Marshall,0,1,0,1
2014,Abril,4,4/1/2014,Mauricio,1,2,0,3
2014,Abril,4,4/1/2014,México,3468,6073,0,9541
2014,Abril,4,4/1/2014,República de Moldavia,2,0,0,2
2014,Abril,4,4/1/2014,Mónaco,0,1,0,1
2014,Abril,4,4/1/2014,Montenegro,2,2,0,4
2014,Abril,4,4/1/2014,Mozambique,4,10,0,14
2014,Abril,4,4/1/2014,Myanmar,4,10,0,14
2014,Abril,4,4/1/2014,Namibia,3,7,0,10
2014,Abril,4,4/1/2014,Nepal,4,9,0,13
2014,Abril,4,4/1/2014,Nicaragua,76,107,0,183
2014,Abril,4,4/1/2014,Nigeria,13,65,0,78
2014,Abril,4,4/1/2014,Níger,0,3,0,3
2014,Abril,4,4/1/2014,Noruega,115,141,0,256
2014,Abril,4,4/1/2014,Nueva Zelanda,54,95,0,149
2014,Abril,4,4/1/2014,Omán,0,2,0,2
2014,Abril,4,4/1/2014,Papúa Nueva Guinea,0,1,0,1
2014,Abril,4,4/1/2014,Pakistán,1,7,0,8
2014,Abril,4,4/1/2014,Panamá,1005,1473,0,2478
2014,Abril,4,4/1/2014,Paraguay,165,176,0,341
2014,Abril,4,4/1/2014,Perú,3798,4885,0,8683
2014,Abril,4,4/1/2014,Palestina,3,8,0,11
2014,Abril,4,4/1/2014,Polonia,91,154,0,245
2014,Abril,4,4/1/2014,Portugal,155,394,0,549
2014,Abril,4,4/1/2014,Puerto Rico/Territorio de Estados Unidos,1,1,0,2
2014,Abril,4,4/1/2014,Reino Unido de Gran Bretaña e Irlanda del Norte,974,1928,0,2902
2014,Abril,4,4/1/2014,República CentroÁfricana,0,3,0,3
2014,Abril,4,4/1/2014,Federación de Rusia,153,193,0,346
2014,Abril,4,4/1/2014,República Dominicana,360,571,0,931
2014,Abril,4,4/1/2014,República Democrática Popular de Corea,1,2,0,3
2014,Abril,4,4/1/2014,Rumania,41,66,0,107
2014,Abril,4,4/1/2014,Rwanda,1,3,0,4
2014,Abril,4,4/1/2014,San Cristóbal y Nevis,4,5,0,9
2014,Abril,4,4/1/2014,Samoa Occidental,0,1,0,1
2014,Abril,4,4/1/2014,San  Vicente y las Granadinas,0,2,0,2
2014,Abril,4,4/1/2014,Santa Lucia,3,3,0,6
2014,Abril,4,4/1/2014,Santa Sede/Ciudad del Vaticano,0,1,0,1
2014,Abril,4,4/1/2014,Senegal,5,10,0,15
2014,Abril,4,4/1/2014,Serbia,11,14,0,25
2014,Abril,4,4/1/2014,Sierra Leona,0,2,0,2
2014,Abril,4,4/1/2014,Singapur,7,18,0,25
2014,Abril,4,4/1/2014,República Árabe Siria,1,2,0,3
2014,Abril,4,4/1/2014,Sri Lanka,1,12,0,13
2014,Abril,4,4/1/2014,Sudáfrica,82,134,0,216
2014,Abril,4,4/1/2014,Sudán,5,11,0,16
2014,Abril,4,4/1/2014,Suecia,209,314,0,523
2014,Abril,4,4/1/2014,Suiza,342,611,0,953
2014,Abril,4,4/1/2014,Surinam,16,22,0,38
2014,Abril,4,4/1/2014,Suazilandia,2,5,0,7
2014,Abril,4,4/1/2014,Taiwán,34,91,0,125
2014,Abril,4,4/1/2014,República de Tayikistán,1,0,0,1
2014,Abril,4,4/1/2014,Tailandia,9,14,0,23
2014,Abril,4,4/1/2014,Territorio Británico del Océano Índico/Territorios Británicos de Ultramar,0,1,0,1
2014,Abril,4,4/1/2014,Tanzania,12,22,0,34
2014,Abril,4,4/1/2014,Togo,1,7,0,8
2014,Abril,4,4/1/2014,Trinidad y Tobago,37,78,0,115
2014,Abril,4,4/1/2014,Túnez,5,4,0,9
2014,Abril,4,4/1/2014,Turquía,26,87,0,113
2014,Abril,4,4/1/2014,Tuvalu,0,2,0,2
2014,Abril,4,4/1/2014,Ucrania,20,35,0,55
2014,Abril,4,4/1/2014,Uganda,12,24,0,36
2014,Abril,4,4/1/2014,Uruguay,357,504,0,861
2014,Abril,4,4/1/2014,Venezuela,9128,11189,0,20317
2014,Abril,4,4/1/2014,Vietnam,2,6,0,8
2014,Abril,4,4/1/2014,República Árabe de Yemen,3,5,0,8
2014,Abril,4,4/1/2014,Zambia,4,8,0,12
2014,Abril,4,4/1/2014,Zimbabue,5,13,0,18
2014,Abril,4,4/1/2014,Desconocido,84,141,0,225
2014,Mayo,5,5/1/2014,Albania,7,8,0,15
2014,Mayo,5,5/1/2014,Alemania,1169,2073,0,3242
2014,Mayo,5,5/1/2014,Andorra,0,6,0,6
2014,Mayo,5,5/1/2014,Angola,0,1,0,1
2014,Mayo,5,5/1/2014,Antigua y Barbuda,1,4,0,5
2014,Mayo,5,5/1/2014,Países Bajos,1003,1685,0,2688
2014,Mayo,5,5/1/2014,Arabia Saudita,2,11,0,13
2014,Mayo,5,5/1/2014,Argelia,3,3,0,6
2014,Mayo,5,5/1/2014,Argentina,4038,5761,0,9799
2014,Mayo,5,5/1/2014,República de Armenia,1,2,0,3
2014,Mayo,5,5/1/2014,Australia,322,692,0,1014
2014,Mayo,5,5/1/2014,Austria,91,213,0,304
2014,Mayo,5,5/1/2014,Azerbaiyán,0,3,0,3
2014,Mayo,5,5/1/2014,Bahamas,0,4,0,4
2014,Mayo,5,5/1/2014,Bahréin,1,3,0,4
2014,Mayo,5,5/1/2014,Bangladesh,3,7,0,10
2014,Mayo,5,5/1/2014,Barbados,11,9,0,20
2014,Mayo,5,5/1/2014,República de Belarús,2,3,0,5
2014,Mayo,5,5/1/2014,Bélgica,139,375,0,514
2014,Mayo,5,5/1/2014,Belice,4,14,0,18
2014,Mayo,5,5/1/2014,Benín,0,2,0,2
2014,Mayo,5,5/1/2014,Bermudas/Territorio Británico de Ultramar,0,2,0,2
2014,Mayo,5,5/1/2014,Bolivia,393,543,0,936
2014,Mayo,5,5/1/2014,Bosnia y Herzegovina,0,1,0,1
2014,Mayo,5,5/1/2014,Botsuana,2,0,0,2
2014,Mayo,5,5/1/2014,Brasil,3963,5410,0,9373
2014,Mayo,5,5/1/2014,Brunei Darussalam,0,1,0,1
2014,Mayo,5,5/1/2014,Bulgaria,16,37,0,53
2014,Mayo,5,5/1/2014,Burkina Faso,1,1,0,2
2014,Mayo,5,5/1/2014,Islas Caimán/Territorio Británico de Ultramar,2,4,0,6
2014,Mayo,5,5/1/2014,Camerún,1,1,0,2
2014,Mayo,5,5/1/2014,Canadá,870,1691,0,2561
2014,Mayo,5,5/1/2014,España,2133,5744,0,7877
2014,Mayo,5,5/1/2014,República Democrática del Congo,1,0,0,1
2014,Mayo,5,5/1/2014,República de Corea,158,492,0,650
2014,Mayo,5,5/1/2014,Costa Rica,713,1152,0,1865
2014,Mayo,5,5/1/2014,Croacia,5,44,0,49
2014,Mayo,5,5/1/2014,Cuba,141,273,0,414
2014,Mayo,5,5/1/2014,Curazao,0,1,0,1
2014,Mayo,5,5/1/2014,República Checa,33,27,0,60
2014,Mayo,5,5/1/2014,Chile,4132,5318,0,9450
2014,Mayo,5,5/1/2014,China,194,608,0,802
2014,Mayo,5,5/1/2014,Chipre,4,7,0,11
2014,Mayo,5,5/1/2014,Dinamarca,61,162,0,223
2014,Mayo,5,5/1/2014,República de Yibuti,1,0,0,1
2014,Mayo,5,5/1/2014,Dominica,2,2,0,4
2014,Mayo,5,5/1/2014,Ecuador,3502,5848,0,9350
2014,Mayo,5,5/1/2014,Egipto,6,24,0,30
2014,Mayo,5,5/1/2014,El Salvador,622,870,0,1492
2014,Mayo,5,5/1/2014,Emiratos Árabes,1,6,0,7
2014,Mayo,5,5/1/2014,Eslovaquia,13,14,0,27
2014,Mayo,5,5/1/2014,Eslovenia,6,14,0,20
2014,Mayo,5,5/1/2014,Estados Unidos de América,9607,19101,0,28708
2014,Mayo,5,5/1/2014,Estonia,6,10,0,16
2014,Mayo,5,5/1/2014,Etiopia,2,1,0,3
2014,Mayo,5,5/1/2014,Filipinas,33,270,0,303
2014,Mayo,5,5/1/2014,Finlandia,41,86,0,127
2014,Mayo,5,5/1/2014,Francia,1028,2092,0,3120
2014,Mayo,5,5/1/2014,Georgia,2,3,0,5
2014,Mayo,5,5/1/2014,Ghana,0,5,0,5
2014,Mayo,5,5/1/2014,Granada,0,2,0,2
2014,Mayo,5,5/1/2014,Grecia,20,72,0,92
2014,Mayo,5,5/1/2014,Guatemala,364,733,0,1097
2014,Mayo,5,5/1/2014,Guyana,7,27,0,34
2014,Mayo,5,5/1/2014,Guinea,0,2,0,2
2014,Mayo,5,5/1/2014,Guinea Ecuatorial,1,1,0,2
2014,Mayo,5,5/1/2014,Haití,6,13,0,19
2014,Mayo,5,5/1/2014,Honduras,203,352,0,555
2014,Mayo,5,5/1/2014,Hungría,18,49,0,67
2014,Mayo,5,5/1/2014,India,56,331,0,387
2014,Mayo,5,5/1/2014,Indonesia,12,30,0,42
2014,Mayo,5,5/1/2014,Iraq,2,0,0,2
2014,Mayo,5,5/1/2014,Irán,8,19,0,27
2014,Mayo,5,5/1/2014,República de Irlanda,104,206,0,310
2014,Mayo,5,5/1/2014,Islandia,6,11,0,17
2014,Mayo,5,5/1/2014,Israel,209,939,0,1148
2014,Mayo,5,5/1/2014,Italia,487,1763,0,2250
2014,Mayo,5,5/1/2014,Jamaica,23,65,0,88
2014,Mayo,5,5/1/2014,Japón,137,603,0,740
2014,Mayo,5,5/1/2014,Jordania,3,5,0,8
2014,Mayo,5,5/1/2014,Kazajistán,4,2,0,6
2014,Mayo,5,5/1/2014,Kenia,15,10,0,25
2014,Mayo,5,5/1/2014,Kirguistán,0,1,0,1
2014,Mayo,5,5/1/2014,Kuwait,0,2,0,2
2014,Mayo,5,5/1/2014,República de Kosovo,1,1,0,2
2014,Mayo,5,5/1/2014,Letonia,10,12,0,22
2014,Mayo,5,5/1/2014,Lituania,5,10,0,15
2014,Mayo,5,5/1/2014,Líbano,17,32,0,49
2014,Mayo,5,5/1/2014,Liberia,0,1,0,1
2014,Mayo,5,5/1/2014,Libia,0,1,0,1
2014,Mayo,5,5/1/2014,Liechtenstein,0,1,0,1
2014,Mayo,5,5/1/2014,Luxemburgo,3,13,0,16
2014,Mayo,5,5/1/2014,Macedonia,1,0,0,1
2014,Mayo,5,5/1/2014,Malasia,15,28,0,43
2014,Mayo,5,5/1/2014,Malta,1,4,0,5
2014,Mayo,5,5/1/2014,Marruecos,8,15,0,23
2014,Mayo,5,5/1/2014,Mauricio,1,3,0,4
2014,Mayo,5,5/1/2014,México,2997,6537,0,9534
2014,Mayo,5,5/1/2014,República de Moldavia,3,1,0,4
2014,Mayo,5,5/1/2014,Mongolia,0,1,0,1
2014,Mayo,5,5/1/2014,Mozambique,2,0,0,2
2014,Mayo,5,5/1/2014,Myanmar,3,0,0,3
2014,Mayo,5,5/1/2014,Nepal,0,5,0,5
2014,Mayo,5,5/1/2014,Nicaragua,77,123,0,200
2014,Mayo,5,5/1/2014,Nigeria,1,14,0,15
2014,Mayo,5,5/1/2014,Noruega,61,109,0,170
2014,Mayo,5,5/1/2014,Nueva Zelanda,64,119,0,183
2014,Mayo,5,5/1/2014,Omán,0,2,0,2
2014,Mayo,5,5/1/2014,Papúa Nueva Guinea,1,0,0,1
2014,Mayo,5,5/1/2014,Pakistán,2,6,0,8
2014,Mayo,5,5/1/2014,Panamá,1061,1582,0,2643
2014,Mayo,5,5/1/2014,Paraguay,173,187,0,360
2014,Mayo,5,5/1/2014,Perú,4661,5694,0,10355
2014,Mayo,5,5/1/2014,Palestina,2,2,0,4
2014,Mayo,5,5/1/2014,Polonia,80,173,0,253
2014,Mayo,5,5/1/2014,Portugal,124,371,0,495
2014,Mayo,5,5/1/2014,Puerto Rico/Territorio de Estados Unidos,0,1,0,1
2014,Mayo,5,5/1/2014,Qatar,0,1,0,1
2014,Mayo,5,5/1/2014,Reino Unido de Gran Bretaña e Irlanda del Norte,792,1713,0,2505
2014,Mayo,5,5/1/2014,República CentroÁfricana,1,0,0,1
2014,Mayo,5,5/1/2014,Federación de Rusia,140,206,0,346
2014,Mayo,5,5/1/2014,República Dominicana,316,558,0,874
2014,Mayo,5,5/1/2014,Rumania,37,61,0,98
2014,Mayo,5,5/1/2014,Rwanda,0,1,0,1
2014,Mayo,5,5/1/2014,San Cristóbal y Nevis,1,3,0,4
2014,Mayo,5,5/1/2014,Santa Lucia,3,1,0,4
2014,Mayo,5,5/1/2014,Santa Sede/Ciudad del Vaticano,0,1,0,1
2014,Mayo,5,5/1/2014,Senegal,3,14,0,17
2014,Mayo,5,5/1/2014,Serbia,1,10,0,11
2014,Mayo,5,5/1/2014,Singapur,13,36,0,49
2014,Mayo,5,5/1/2014,República Árabe Siria,1,6,0,7
2014,Mayo,5,5/1/2014,Sri Lanka,1,3,0,4
2014,Mayo,5,5/1/2014,Sudáfrica,33,95,0,128
2014,Mayo,5,5/1/2014,Suecia,137,221,0,358
2014,Mayo,5,5/1/2014,Suiza,297,613,0,910
2014,Mayo,5,5/1/2014,Surinam,22,44,0,66
2014,Mayo,5,5/1/2014,Taiwán,53,87,0,140
2014,Mayo,5,5/1/2014,Tailandia,26,33,0,59
2014,Mayo,5,5/1/2014,Tanzania,0,1,0,1
2014,Mayo,5,5/1/2014,Togo,0,1,0,1
2014,Mayo,5,5/1/2014,Trinidad y Tobago,26,74,0,100
2014,Mayo,5,5/1/2014,Túnez,3,2,0,5
2014,Mayo,5,5/1/2014,Turquía,22,83,0,105
2014,Mayo,5,5/1/2014,Ucrania,16,40,0,56
2014,Mayo,5,5/1/2014,Uganda,1,1,0,2
2014,Mayo,5,5/1/2014,Uruguay,335,561,0,896
2014,Mayo,5,5/1/2014,Uzbekistán,2,0,0,2
2014,Mayo,5,5/1/2014,Venezuela,6746,9533,0,16279
2014,Mayo,5,5/1/2014,Vietnam,0,4,0,4
2014,Mayo,5,5/1/2014,Zambia,0,1,0,1
2014,Mayo,5,5/1/2014,Zimbabue,3,5,0,8
2014,Mayo,5,5/1/2014,Desconocido,55,84,0,139
2014,Junio,6,6/1/2014,Afganistán,0,1,0,1
2014,Junio,6,6/1/2014,Albania,2,1,0,3
2014,Junio,6,6/1/2014,Alemania,1152,1772,0,2924
2014,Junio,6,6/1/2014,Andorra,0,4,0,4
2014,Junio,6,6/1/2014,Antigua y Barbuda,1,2,0,3
2014,Junio,6,6/1/2014,Países Bajos,986,1535,0,2521
2014,Junio,6,6/1/2014,Arabia Saudita,1,9,0,10
2014,Junio,6,6/1/2014,Argelia,1,3,0,4
2014,Junio,6,6/1/2014,Argentina,3204,4697,0,7901
2014,Junio,6,6/1/2014,Aruba,1,0,0,1
2014,Junio,6,6/1/2014,Australia,352,752,0,1104
2014,Junio,6,6/1/2014,Austria,106,217,0,323
2014,Junio,6,6/1/2014,Azerbaiyán,0,3,0,3
2014,Junio,6,6/1/2014,Bahamas,3,15,0,18
2014,Junio,6,6/1/2014,Bahréin,0,1,0,1
2014,Junio,6,6/1/2014,Bangladesh,0,3,0,3
2014,Junio,6,6/1/2014,Barbados,4,4,0,8
2014,Junio,6,6/1/2014,República de Belarús,5,2,0,7
2014,Junio,6,6/1/2014,Bélgica,193,390,0,583
2014,Junio,6,6/1/2014,Belice,2,10,0,12
2014,Junio,6,6/1/2014,Benín,0,1,0,1
2014,Junio,6,6/1/2014,Bermudas/Territorio Británico de Ultramar,0,1,0,1
2014,Junio,6,6/1/2014,Bolivia,516,615,0,1131
2014,Junio,6,6/1/2014,Brasil,2715,3868,0,6583
2014,Junio,6,6/1/2014,Bulgaria,12,25,0,37
2014,Junio,6,6/1/2014,Burkina Faso,1,0,0,1
2014,Junio,6,6/1/2014,Burundi,0,2,0,2
2014,Junio,6,6/1/2014,Cabo Verde,1,1,0,2
2014,Junio,6,6/1/2014,Islas Caimán/Territorio Británico de Ultramar,1,4,0,5
2014,Junio,6,6/1/2014,Camerún,2,4,0,6
2014,Junio,6,6/1/2014,Canadá,993,1713,0,2706
2014,Junio,6,6/1/2014,España,2639,6087,0,8726
2014,Junio,6,6/1/2014,República Democrática del Congo,2,0,0,2
2014,Junio,6,6/1/2014,República de Corea,162,478,0,640
2014,Junio,6,6/1/2014,Costa Rica,675,1119,0,1794
2014,Junio,6,6/1/2014,Croacia,7,54,0,61
2014,Junio,6,6/1/2014,Cuba,156,250,0,406
2014,Junio,6,6/1/2014,Curazao,3,1,0,4
2014,Junio,6,6/1/2014,República Checa,25,36,0,61
2014,Junio,6,6/1/2014,Chile,2317,3544,0,5861
2014,Junio,6,6/1/2014,China,184,469,0,653
2014,Junio,6,6/1/2014,Chipre,2,9,0,11
2014,Junio,6,6/1/2014,Dinamarca,74,126,0,200
2014,Junio,6,6/1/2014,Dominica,1,4,0,5
2014,Junio,6,6/1/2014,Ecuador,3416,5497,0,8913
2014,Junio,6,6/1/2014,Egipto,1,19,0,20
2014,Junio,6,6/1/2014,El Salvador,637,847,0,1484
2014,Junio,6,6/1/2014,Emiratos Árabes,3,6,0,9
2014,Junio,6,6/1/2014,Eslovaquia,17,14,0,31
2014,Junio,6,6/1/2014,Eslovenia,4,19,0,23
2014,Junio,6,6/1/2014,Estados Unidos de América,16623,25092,0,41715
2014,Junio,6,6/1/2014,Estonia,3,5,0,8
2014,Junio,6,6/1/2014,Etiopia,1,0,0,1
2014,Junio,6,6/1/2014,Islas Fiji,1,1,0,2
2014,Junio,6,6/1/2014,Filipinas,37,194,0,231
2014,Junio,6,6/1/2014,Finlandia,39,96,0,135
2014,Junio,6,6/1/2014,Francia,1209,2124,0,3333
2014,Junio,6,6/1/2014,Georgia,1,0,0,1
2014,Junio,6,6/1/2014,Ghana,1,10,0,11
2014,Junio,6,6/1/2014,Granada,1,3,0,4
2014,Junio,6,6/1/2014,Grecia,17,61,0,78
2014,Junio,6,6/1/2014,Guatemala,448,828,0,1276
2014,Junio,6,6/1/2014,Guyana,7,23,0,30
2014,Junio,6,6/1/2014,Guinea,1,1,0,2
2014,Junio,6,6/1/2014,Guinea Ecuatorial,0,1,0,1
2014,Junio,6,6/1/2014,Haití,10,21,0,31
2014,Junio,6,6/1/2014,Honduras,193,317,0,510
2014,Junio,6,6/1/2014,Hong Kong,1,1,0,2
2014,Junio,6,6/1/2014,Hungría,22,34,0,56
2014,Junio,6,6/1/2014,India,53,330,0,383
2014,Junio,6,6/1/2014,Indonesia,15,42,0,57
2014,Junio,6,6/1/2014,Iraq,0,1,0,1
2014,Junio,6,6/1/2014,Irán,3,11,0,14
2014,Junio,6,6/1/2014,República de Irlanda,112,207,0,319
2014,Junio,6,6/1/2014,Islandia,1,25,0,26
2014,Junio,6,6/1/2014,Israel,154,751,0,905
2014,Junio,6,6/1/2014,Italia,617,1741,0,2358
2014,Junio,6,6/1/2014,Jamaica,18,60,0,78
2014,Junio,6,6/1/2014,Japón,153,501,0,654
2014,Junio,6,6/1/2014,Jordania,6,6,0,12
2014,Junio,6,6/1/2014,Kazajistán,2,0,0,2
2014,Junio,6,6/1/2014,Kenia,2,6,0,8
2014,Junio,6,6/1/2014,Kuwait,1,2,0,3
2014,Junio,6,6/1/2014,Letonia,6,33,0,39
2014,Junio,6,6/1/2014,Lituania,9,9,0,18
2014,Junio,6,6/1/2014,Líbano,10,27,0,37
2014,Junio,6,6/1/2014,Liechtenstein,4,2,0,6
2014,Junio,6,6/1/2014,Luxemburgo,1,6,0,7
2014,Junio,6,6/1/2014,Madagascar,0,1,0,1
2014,Junio,6,6/1/2014,Malasia,17,32,0,49
2014,Junio,6,6/1/2014,Malawi,0,1,0,1
2014,Junio,6,6/1/2014,Malta,2,10,0,12
2014,Junio,6,6/1/2014,Marruecos,1,14,0,15
2014,Junio,6,6/1/2014,Mauricio,1,0,0,1
2014,Junio,6,6/1/2014,Mauritania,0,2,0,2
2014,Junio,6,6/1/2014,México,3162,6177,0,9339
2014,Junio,6,6/1/2014,República de Moldavia,1,0,0,1
2014,Junio,6,6/1/2014,Mongolia,0,2,0,2
2014,Junio,6,6/1/2014,Montenegro,0,1,0,1
2014,Junio,6,6/1/2014,Mozambique,0,1,0,1
2014,Junio,6,6/1/2014,Myanmar,1,1,0,2
2014,Junio,6,6/1/2014,Nepal,1,0,0,1
2014,Junio,6,6/1/2014,Nicaragua,86,96,0,182
2014,Junio,6,6/1/2014,Nigeria,12,23,0,35
2014,Junio,6,6/1/2014,Níger,1,0,0,1
2014,Junio,6,6/1/2014,Noruega,123,177,0,300
2014,Junio,6,6/1/2014,Nueva Zelanda,62,113,0,175
2014,Junio,6,6/1/2014,Pakistán,1,12,0,13
2014,Junio,6,6/1/2014,Panamá,1148,1694,0,2842
2014,Junio,6,6/1/2014,Paraguay,169,204,0,373
2014,Junio,6,6/1/2014,Perú,3878,4898,0,8776
2014,Junio,6,6/1/2014,Palestina,1,1,0,2
2014,Junio,6,6/1/2014,Polonia,101,129,0,230
2014,Junio,6,6/1/2014,Portugal,139,407,0,546
2014,Junio,6,6/1/2014,Puerto Rico/Territorio de Estados Unidos,0,1,0,1
2014,Junio,6,6/1/2014,Reino Unido de Gran Bretaña e Irlanda del Norte,808,1738,0,2546
2014,Junio,6,6/1/2014,Federación de Rusia,124,155,0,279
2014,Junio,6,6/1/2014,República Dominicana,457,623,0,1080
2014,Junio,6,6/1/2014,Rumania,32,52,0,84
2014,Junio,6,6/1/2014,Rwanda,0,2,0,2
2014,Junio,6,6/1/2014,San Cristóbal y Nevis,2,5,0,7
2014,Junio,6,6/1/2014,San  Vicente y las Granadinas,0,5,0,5
2014,Junio,6,6/1/2014,Santa Lucia,2,2,0,4
2014,Junio,6,6/1/2014,Senegal,0,1,0,1
2014,Junio,6,6/1/2014,Serbia,6,8,0,14
2014,Junio,6,6/1/2014,Singapur,19,24,0,43
2014,Junio,6,6/1/2014,República Árabe Siria,0,3,0,3
2014,Junio,6,6/1/2014,Sri Lanka,0,2,0,2
2014,Junio,6,6/1/2014,Sudáfrica,23,92,0,115
2014,Junio,6,6/1/2014,Sudán,1,0,0,1
2014,Junio,6,6/1/2014,Suecia,192,292,0,484
2014,Junio,6,6/1/2014,Suiza,363,635,0,998
2014,Junio,6,6/1/2014,Surinam,12,15,0,27
2014,Junio,6,6/1/2014,Taiwán,50,76,0,126
2014,Junio,6,6/1/2014,Tailandia,6,5,0,11
2014,Junio,6,6/1/2014,Trinidad y Tobago,149,196,0,345
2014,Junio,6,6/1/2014,Túnez,1,0,0,1
2014,Junio,6,6/1/2014,Turquía,30,99,0,129
2014,Junio,6,6/1/2014,Ucrania,18,41,0,59
2014,Junio,6,6/1/2014,Uganda,0,1,0,1
2014,Junio,6,6/1/2014,Uruguay,289,459,0,748
2014,Junio,6,6/1/2014,Venezuela,9253,11721,0,20974
2014,Junio,6,6/1/2014,Vietnam,2,2,0,4
2014,Junio,6,6/1/2014,República Árabe de Yemen,0,1,0,1
2014,Junio,6,6/1/2014,Zambia,2,0,0,2
2014,Junio,6,6/1/2014,Zimbabue,0,2,0,2
2014,Junio,6,6/1/2014,Desconocido,41,79,0,120
2014,Julio,7,7/1/2014,Albania,3,6,0,9
2014,Julio,7,7/1/2014,Alemania,2065,2563,0,4628
2014,Julio,7,7/1/2014,Andorra,1,5,0,6
2014,Julio,7,7/1/2014,Antigua y Barbuda,1,1,0,2
2014,Julio,7,7/1/2014,Países Bajos,1894,2494,0,4388
2014,Julio,7,7/1/2014,Arabia Saudita,1,11,0,12
2014,Julio,7,7/1/2014,Argelia,1,2,0,3
2014,Julio,7,7/1/2014,Argentina,4110,5410,0,9520
2014,Julio,7,7/1/2014,República de Armenia,1,3,0,4
2014,Julio,7,7/1/2014,Aruba,1,1,0,2
2014,Julio,7,7/1/2014,Australia,466,836,0,1302
2014,Julio,7,7/1/2014,Austria,245,311,0,556
2014,Julio,7,7/1/2014,Azerbaiyán,0,2,0,2
2014,Julio,7,7/1/2014,Bahamas,3,5,0,8
2014,Julio,7,7/1/2014,Bahréin,0,2,0,2
2014,Julio,7,7/1/2014,Bangladesh,0,1,0,1
2014,Julio,7,7/1/2014,Barbados,9,7,0,16
2014,Julio,7,7/1/2014,República de Belarús,3,1,0,4
2014,Julio,7,7/1/2014,Bélgica,314,584,0,898
2014,Julio,7,7/1/2014,Belice,5,23,0,28
2014,Julio,7,7/1/2014,Bermudas/Territorio Británico de Ultramar,1,7,0,8
2014,Julio,7,7/1/2014,Bolivia,554,640,0,1194
2014,Julio,7,7/1/2014,Bosnia y Herzegovina,1,1,0,2
2014,Julio,7,7/1/2014,Botsuana,4,1,0,5
2014,Julio,7,7/1/2014,Brasil,4523,5663,0,10186
2014,Julio,7,7/1/2014,Bulgaria,14,33,0,47
2014,Julio,7,7/1/2014,Burkina Faso,0,1,0,1
2014,Julio,7,7/1/2014,Burundi,1,0,0,1
2014,Julio,7,7/1/2014,Cabo Verde,3,1,0,4
2014,Julio,7,7/1/2014,Islas Caimán/Territorio Británico de Ultramar,1,5,0,6
2014,Julio,7,7/1/2014,Camerún,1,3,0,4
2014,Julio,7,7/1/2014,Canadá,1248,2041,0,3289
2014,Julio,7,7/1/2014,España,3003,5992,0,8995
2014,Julio,7,7/1/2014,República Democrática del Congo,5,2,0,7
2014,Julio,7,7/1/2014,República de Corea,227,468,0,695
2014,Julio,7,7/1/2014,Costa de Marfil,3,4,0,7
2014,Julio,7,7/1/2014,Costa Rica,832,1220,0,2052
2014,Julio,7,7/1/2014,Croacia,11,47,0,58
2014,Julio,7,7/1/2014,Cuba,210,341,0,551
2014,Julio,7,7/1/2014,República Checa,53,60,0,113
2014,Julio,7,7/1/2014,Chile,4051,4899,0,8950
2014,Julio,7,7/1/2014,China,237,497,0,734
2014,Julio,7,7/1/2014,Chipre,4,12,0,16
2014,Julio,7,7/1/2014,Dinamarca,116,177,0,293
2014,Julio,7,7/1/2014,Dominica,2,2,0,4
2014,Julio,7,7/1/2014,Ecuador,5112,6997,0,12109
2014,Julio,7,7/1/2014,Egipto,5,32,0,37
2014,Julio,7,7/1/2014,El Salvador,698,924,0,1622
2014,Julio,7,7/1/2014,Emiratos Árabes,0,6,0,6
2014,Julio,7,7/1/2014,Eritrea,1,2,0,3
2014,Julio,7,7/1/2014,Eslovaquia,18,12,0,30
2014,Julio,7,7/1/2014,Eslovenia,19,31,0,50
2014,Julio,7,7/1/2014,Estados Unidos de América,16159,24579,0,40738
2014,Julio,7,7/1/2014,Estonia,7,4,0,11
2014,Julio,7,7/1/2014,Etiopia,4,3,0,7
2014,Julio,7,7/1/2014,Islas Fiji,0,7,0,7
2014,Julio,7,7/1/2014,Filipinas,32,242,0,274
2014,Julio,7,7/1/2014,Finlandia,52,57,0,109
2014,Julio,7,7/1/2014,Francia,2192,3319,0,5511
2014,Julio,7,7/1/2014,Georgia,3,5,0,8
2014,Julio,7,7/1/2014,Ghana,2,12,0,14
2014,Julio,7,7/1/2014,Granada,4,7,0,11
2014,Julio,7,7/1/2014,Grecia,33,100,0,133
2014,Julio,7,7/1/2014,Guatemala,332,790,0,1122
2014,Julio,7,7/1/2014,Guyana,5,18,0,23
2014,Julio,7,7/1/2014,Guinea,0,1,0,1
2014,Julio,7,7/1/2014,Guinea Ecuatorial,3,1,0,4
2014,Julio,7,7/1/2014,Haití,8,41,0,49
2014,Julio,7,7/1/2014,Honduras,181,412,0,593
2014,Julio,7,7/1/2014,Hong Kong,1,0,0,1
2014,Julio,7,7/1/2014,Hungría,23,61,0,84
2014,Julio,7,7/1/2014,India,65,335,0,400
2014,Julio,7,7/1/2014,Indonesia,14,19,0,33
2014,Julio,7,7/1/2014,Iraq,1,3,0,4
2014,Julio,7,7/1/2014,Irán,3,12,0,15
2014,Julio,7,7/1/2014,República de Irlanda,172,268,0,440
2014,Julio,7,7/1/2014,Islandia,7,14,0,21
2014,Julio,7,7/1/2014,Israel,213,742,0,955
2014,Julio,7,7/1/2014,Italia,766,2044,0,2810
2014,Julio,7,7/1/2014,Jamaica,25,42,0,67
2014,Julio,7,7/1/2014,Islas Salomón,1,0,0,1
2014,Julio,7,7/1/2014,Japón,236,809,0,1045
2014,Julio,7,7/1/2014,Jordania,0,4,0,4
2014,Julio,7,7/1/2014,Kazajistán,4,3,0,7
2014,Julio,7,7/1/2014,Kenia,3,16,0,19
2014,Julio,7,7/1/2014,Kirguistán,1,3,0,4
2014,Julio,7,7/1/2014,Kuwait,0,1,0,1
2014,Julio,7,7/1/2014,República de Kosovo,1,0,0,1
2014,Julio,7,7/1/2014,República Democrática Popular  Lao,2,0,0,2
2014,Julio,7,7/1/2014,Letonia,10,13,0,23
2014,Julio,7,7/1/2014,Lituania,15,27,0,42
2014,Julio,7,7/1/2014,Líbano,17,32,0,49
2014,Julio,7,7/1/2014,Liechtenstein,3,1,0,4
2014,Julio,7,7/1/2014,Luxemburgo,9,9,0,18
2014,Julio,7,7/1/2014,Macedonia,1,5,0,6
2014,Julio,7,7/1/2014,Malasia,14,29,0,43
2014,Julio,7,7/1/2014,Malí,0,1,0,1
2014,Julio,7,7/1/2014,Malta,5,8,0,13
2014,Julio,7,7/1/2014,Marruecos,2,13,0,15
2014,Julio,7,7/1/2014,Mauricio,0,2,0,2
2014,Julio,7,7/1/2014,Mauritania,0,4,0,4
2014,Julio,7,7/1/2014,México,4310,7372,0,11682
2014,Julio,7,7/1/2014,República de Moldavia,2,0,0,2
2014,Julio,7,7/1/2014,Mónaco,1,1,0,2
2014,Julio,7,7/1/2014,Mongolia,1,0,0,1
2014,Julio,7,7/1/2014,Montenegro,2,1,0,3
2014,Julio,7,7/1/2014,Nepal,1,5,0,6
2014,Julio,7,7/1/2014,Nicaragua,123,122,0,245
2014,Julio,7,7/1/2014,Nigeria,14,18,0,32
2014,Julio,7,7/1/2014,Noruega,118,180,0,298
2014,Julio,7,7/1/2014,Nueva Zelanda,81,148,0,229
2014,Julio,7,7/1/2014,Pakistán,1,13,0,14
2014,Julio,7,7/1/2014,Panamá,1200,1809,0,3009
2014,Julio,7,7/1/2014,Paraguay,172,202,0,374
2014,Julio,7,7/1/2014,Perú,5975,6825,0,12800
2014,Julio,7,7/1/2014,Palestina,1,1,0,2
2014,Julio,7,7/1/2014,Polonia,164,187,0,351
2014,Julio,7,7/1/2014,Portugal,353,797,0,1150
2014,Julio,7,7/1/2014,Qatar,0,8,0,8
2014,Julio,7,7/1/2014,Reino Unido de Gran Bretaña e Irlanda del Norte,1345,2304,0,3649
2014,Julio,7,7/1/2014,Federación de Rusia,156,179,0,335
2014,Julio,7,7/1/2014,República Dominicana,424,665,0,1089
2014,Julio,7,7/1/2014,Rumania,36,50,0,86
2014,Julio,7,7/1/2014,Rwanda,0,1,0,1
2014,Julio,7,7/1/2014,San Cristóbal y Nevis,2,3,0,5
2014,Julio,7,7/1/2014,San  Vicente y las Granadinas,0,3,0,3
2014,Julio,7,7/1/2014,Santa Lucia,2,3,0,5
2014,Julio,7,7/1/2014,Senegal,0,5,0,5
2014,Julio,7,7/1/2014,Serbia,7,11,0,18
2014,Julio,7,7/1/2014,Sierra Leona,0,2,0,2
2014,Julio,7,7/1/2014,Singapur,14,28,0,42
2014,Julio,7,7/1/2014,República Árabe Siria,0,6,0,6
2014,Julio,7,7/1/2014,Sri Lanka,2,5,0,7
2014,Julio,7,7/1/2014,Sudáfrica,46,122,0,168
2014,Julio,7,7/1/2014,Suecia,159,270,0,429
2014,Julio,7,7/1/2014,Suiza,706,946,0,1652
2014,Julio,7,7/1/2014,Surinam,24,38,0,62
2014,Julio,7,7/1/2014,Taiwán,59,85,0,144
2014,Julio,7,7/1/2014,Tailandia,8,8,0,16
2014,Julio,7,7/1/2014,Tanzania,1,0,0,1
2014,Julio,7,7/1/2014,Trinidad y Tobago,51,98,0,149
2014,Julio,7,7/1/2014,Túnez,2,6,0,8
2014,Julio,7,7/1/2014,Turquía,35,100,0,135
2014,Julio,7,7/1/2014,Ucrania,26,27,0,53
2014,Julio,7,7/1/2014,Uganda,0,3,0,3
2014,Julio,7,7/1/2014,Uruguay,415,553,0,968
2014,Julio,7,7/1/2014,Uzbekistán,1,1,0,2
2014,Julio,7,7/1/2014,Venezuela,12066,14039,0,26105
2014,Julio,7,7/1/2014,Vietnam,3,9,0,12
2014,Julio,7,7/1/2014,Zambia,0,1,0,1
2014,Julio,7,7/1/2014,Zimbabue,0,3,0,3
2014,Julio,7,7/1/2014,Anguila/Territorio Británico de Ultramar,0,1,0,1
2014,Julio,7,7/1/2014,Islas Turcas y Caicos/Territorio Británico de Ultramar,1,1,0,2
2014,Julio,7,7/1/2014,Desconocido,44,79,0,123
2014,Agosto,8,8/1/2014,Afganistán,0,1,0,1
2014,Agosto,8,8/1/2014,Albania,0,3,0,3
2014,Agosto,8,8/1/2014,Alemania,2261,2902,0,5163
2014,Agosto,8,8/1/2014,Andorra,1,6,0,7
2014,Agosto,8,8/1/2014,Angola,2,5,0,7
2014,Agosto,8,8/1/2014,Antigua y Barbuda,2,8,0,10
2014,Agosto,8,8/1/2014,Países Bajos,889,1592,0,2481
2014,Agosto,8,8/1/2014,Arabia Saudita,6,19,0,25
2014,Agosto,8,8/1/2014,Argelia,2,5,0,7
2014,Agosto,8,8/1/2014,Argentina,4472,6095,0,10567
2014,Agosto,8,8/1/2014,República de Armenia,1,2,0,3
2014,Agosto,8,8/1/2014,Aruba,1,0,0,1
2014,Agosto,8,8/1/2014,Australia,407,741,0,1148
2014,Agosto,8,8/1/2014,Austria,208,326,0,534
2014,Agosto,8,8/1/2014,Azerbaiyán,1,3,0,4
2014,Agosto,8,8/1/2014,Bahamas,4,7,0,11
2014,Agosto,8,8/1/2014,Bahréin,0,1,0,1
2014,Agosto,8,8/1/2014,Bangladesh,0,7,0,7
2014,Agosto,8,8/1/2014,Barbados,12,17,0,29
2014,Agosto,8,8/1/2014,República de Belarús,3,3,0,6
2014,Agosto,8,8/1/2014,Bélgica,204,443,0,647
2014,Agosto,8,8/1/2014,Belice,10,19,0,29
2014,Agosto,8,8/1/2014,Benín,0,1,0,1
2014,Agosto,8,8/1/2014,Bermudas/Territorio Británico de Ultramar,1,2,0,3
2014,Agosto,8,8/1/2014,Bolivia,590,615,0,1205
2014,Agosto,8,8/1/2014,Bosnia y Herzegovina,0,2,0,2
2014,Agosto,8,8/1/2014,Brasil,5512,6628,0,12140
2014,Agosto,8,8/1/2014,Brunei Darussalam,0,3,0,3
2014,Agosto,8,8/1/2014,Bulgaria,20,27,0,47
2014,Agosto,8,8/1/2014,Burkina Faso,1,2,0,3
2014,Agosto,8,8/1/2014,Cabo Verde,1,3,0,4
2014,Agosto,8,8/1/2014,Islas Caimán/Territorio Británico de Ultramar,3,5,0,8
2014,Agosto,8,8/1/2014,Camboya,1,0,0,1
2014,Agosto,8,8/1/2014,Camerún,0,3,0,3
2014,Agosto,8,8/1/2014,Canadá,1068,1830,0,2898
2014,Agosto,8,8/1/2014,España,3576,6549,0,10125
2014,Agosto,8,8/1/2014,República Del Congo,0,1,0,1
2014,Agosto,8,8/1/2014,República Democrática del Congo,2,6,0,8
2014,Agosto,8,8/1/2014,República de Corea,200,521,0,721
2014,Agosto,8,8/1/2014,Costa de Marfil,1,4,0,5
2014,Agosto,8,8/1/2014,Costa Rica,828,1314,0,2142
2014,Agosto,8,8/1/2014,Croacia,10,40,0,50
2014,Agosto,8,8/1/2014,Cuba,209,384,0,593
2014,Agosto,8,8/1/2014,Curazao,0,1,0,1
2014,Agosto,8,8/1/2014,República Checa,41,46,0,87
2014,Agosto,8,8/1/2014,Chile,4342,5324,0,9666
2014,Agosto,8,8/1/2014,China,227,577,0,804
2014,Agosto,8,8/1/2014,Chipre,5,4,0,9
2014,Agosto,8,8/1/2014,Dinamarca,59,130,0,189
2014,Agosto,8,8/1/2014,Dominica,4,1,0,5
2014,Agosto,8,8/1/2014,Ecuador,6022,8251,0,14273
2014,Agosto,8,8/1/2014,Egipto,5,23,0,28
2014,Agosto,8,8/1/2014,El Salvador,829,1021,0,1850
2014,Agosto,8,8/1/2014,Emiratos Árabes,3,6,0,9
2014,Agosto,8,8/1/2014,Eritrea,0,2,0,2
2014,Agosto,8,8/1/2014,Eslovaquia,16,16,0,32
2014,Agosto,8,8/1/2014,Eslovenia,10,22,0,32
2014,Agosto,8,8/1/2014,Estados Unidos de América,12185,21865,0,34050
2014,Agosto,8,8/1/2014,Estonia,7,4,0,11
2014,Agosto,8,8/1/2014,Etiopia,4,6,0,10
2014,Agosto,8,8/1/2014,Islas Fiji,4,1,0,5
2014,Agosto,8,8/1/2014,Filipinas,54,201,0,255
2014,Agosto,8,8/1/2014,Finlandia,48,77,0,125
2014,Agosto,8,8/1/2014,Francia,1967,3075,0,5042
2014,Agosto,8,8/1/2014,Georgia,3,1,0,4
2014,Agosto,8,8/1/2014,Ghana,5,10,0,15
2014,Agosto,8,8/1/2014,Granada,2,9,0,11
2014,Agosto,8,8/1/2014,Grecia,35,76,0,111
2014,Agosto,8,8/1/2014,Guatemala,391,998,0,1389
2014,Agosto,8,8/1/2014,Guyana,7,17,0,24
2014,Agosto,8,8/1/2014,Guinea,1,1,0,2
2014,Agosto,8,8/1/2014,Guinea Ecuatorial,0,8,0,8
2014,Agosto,8,8/1/2014,Haití,13,35,0,48
2014,Agosto,8,8/1/2014,Honduras,258,391,0,649
2014,Agosto,8,8/1/2014,Hong Kong,0,1,0,1
2014,Agosto,8,8/1/2014,Hungría,21,44,0,65
2014,Agosto,8,8/1/2014,India,56,329,0,385
2014,Agosto,8,8/1/2014,Indonesia,15,36,0,51
2014,Agosto,8,8/1/2014,Iraq,0,1,0,1
2014,Agosto,8,8/1/2014,Irán,5,18,0,23
2014,Agosto,8,8/1/2014,República de Irlanda,157,246,0,403
2014,Agosto,8,8/1/2014,Islandia,0,8,0,8
2014,Agosto,8,8/1/2014,Israel,162,652,0,814
2014,Agosto,8,8/1/2014,Italia,1048,2553,0,3601
2014,Agosto,8,8/1/2014,Jamaica,26,56,0,82
2014,Agosto,8,8/1/2014,Japón,205,612,0,817
2014,Agosto,8,8/1/2014,Jordania,2,2,0,4
2014,Agosto,8,8/1/2014,Kazajistán,2,8,0,10
2014,Agosto,8,8/1/2014,Kenia,10,24,0,34
2014,Agosto,8,8/1/2014,Kirguistán,2,1,0,3
2014,Agosto,8,8/1/2014,Kuwait,3,5,0,8
2014,Agosto,8,8/1/2014,República de Kosovo,0,2,0,2
2014,Agosto,8,8/1/2014,República Democrática Popular  Lao,0,2,0,2
2014,Agosto,8,8/1/2014,Letonia,7,5,0,12
2014,Agosto,8,8/1/2014,Lituania,13,15,0,28
2014,Agosto,8,8/1/2014,Líbano,17,26,0,43
2014,Agosto,8,8/1/2014,Libia,0,1,0,1
2014,Agosto,8,8/1/2014,Liechtenstein,6,10,0,16
2014,Agosto,8,8/1/2014,Luxemburgo,31,39,0,70
2014,Agosto,8,8/1/2014,Macedonia,3,3,0,6
2014,Agosto,8,8/1/2014,Malasia,22,27,0,49
2014,Agosto,8,8/1/2014,Malawi,0,1,0,1
2014,Agosto,8,8/1/2014,Malí,0,4,0,4
2014,Agosto,8,8/1/2014,Malta,3,5,0,8
2014,Agosto,8,8/1/2014,Marruecos,12,18,0,30
2014,Agosto,8,8/1/2014,Mauricio,0,1,0,1
2014,Agosto,8,8/1/2014,México,3523,6739,0,10262
2014,Agosto,8,8/1/2014,República de Moldavia,4,1,0,5
2014,Agosto,8,8/1/2014,Mónaco,1,0,0,1
2014,Agosto,8,8/1/2014,Micronesia,2,0,0,2
2014,Agosto,8,8/1/2014,Mozambique,1,5,0,6
2014,Agosto,8,8/1/2014,Myanmar,0,3,0,3
2014,Agosto,8,8/1/2014,Namibia,0,2,0,2
2014,Agosto,8,8/1/2014,Nepal,1,3,0,4
2014,Agosto,8,8/1/2014,Nicaragua,103,137,0,240
2014,Agosto,8,8/1/2014,Nigeria,10,14,0,24
2014,Agosto,8,8/1/2014,Noruega,52,129,0,181
2014,Agosto,8,8/1/2014,Nueva Zelanda,79,146,0,225
2014,Agosto,8,8/1/2014,Papúa Nueva Guinea,2,2,0,4
2014,Agosto,8,8/1/2014,Pakistán,4,13,0,17
2014,Agosto,8,8/1/2014,Palau,2,0,0,2
2014,Agosto,8,8/1/2014,Panamá,1876,2749,0,4625
2014,Agosto,8,8/1/2014,Paraguay,187,212,0,399
2014,Agosto,8,8/1/2014,Perú,6636,7436,0,14072
2014,Agosto,8,8/1/2014,Palestina,2,9,0,11
2014,Agosto,8,8/1/2014,Polonia,136,200,0,336
2014,Agosto,8,8/1/2014,Portugal,316,634,0,950
2014,Agosto,8,8/1/2014,Qatar,0,8,0,8
2014,Agosto,8,8/1/2014,Reino Unido de Gran Bretaña e Irlanda del Norte,1064,1991,0,3055
2014,Agosto,8,8/1/2014,República CentroÁfricana,5,0,0,5
2014,Agosto,8,8/1/2014,Federación de Rusia,148,179,0,327
2014,Agosto,8,8/1/2014,República Dominicana,479,772,0,1251
2014,Agosto,8,8/1/2014,Rumania,38,58,0,96
2014,Agosto,8,8/1/2014,Rwanda,0,3,0,3
2014,Agosto,8,8/1/2014,San Cristóbal y Nevis,2,3,0,5
2014,Agosto,8,8/1/2014,Samoa Occidental,3,2,0,5
2014,Agosto,8,8/1/2014,San  Vicente y las Granadinas,0,8,0,8
2014,Agosto,8,8/1/2014,Santa Lucia,7,7,0,14
2014,Agosto,8,8/1/2014,Senegal,1,8,0,9
2014,Agosto,8,8/1/2014,Serbia,8,10,0,18
2014,Agosto,8,8/1/2014,Singapur,19,25,0,44
2014,Agosto,8,8/1/2014,República Árabe Siria,0,4,0,4
2014,Agosto,8,8/1/2014,Sri Lanka,4,9,0,13
2014,Agosto,8,8/1/2014,Sudáfrica,36,98,0,134
2014,Agosto,8,8/1/2014,Sudán,0,1,0,1
2014,Agosto,8,8/1/2014,Suecia,135,207,0,342
2014,Agosto,8,8/1/2014,Suiza,392,647,0,1039
2014,Agosto,8,8/1/2014,Surinam,12,32,0,44
2014,Agosto,8,8/1/2014,Taiwán,64,89,0,153
2014,Agosto,8,8/1/2014,Tailandia,10,11,0,21
2014,Agosto,8,8/1/2014,Togo,0,1,0,1
2014,Agosto,8,8/1/2014,Trinidad y Tobago,33,111,0,144
2014,Agosto,8,8/1/2014,Túnez,1,7,0,8
2014,Agosto,8,8/1/2014,Turquía,55,108,0,163
2014,Agosto,8,8/1/2014,Ucrania,16,33,0,49
2014,Agosto,8,8/1/2014,Uganda,2,4,0,6
2014,Agosto,8,8/1/2014,Uruguay,423,626,0,1049
2014,Agosto,8,8/1/2014,Uzbekistán,1,0,0,1
2014,Agosto,8,8/1/2014,Venezuela,15347,17272,0,32619
2014,Agosto,8,8/1/2014,Vietnam,3,9,0,12
2014,Agosto,8,8/1/2014,República Árabe de Yemen,0,1,0,1
2014,Agosto,8,8/1/2014,Zambia,2,3,0,5
2014,Agosto,8,8/1/2014,Zimbabue,0,8,0,8
2014,Agosto,8,8/1/2014,Desconocido,39,90,0,129
2014,Septiembre,9,9/1/2014,Albania,0,1,0,1
2014,Septiembre,9,9/1/2014,Alemania,1498,2393,0,3891
2014,Septiembre,9,9/1/2014,Andorra,1,8,0,9
2014,Septiembre,9,9/1/2014,Angola,0,1,0,1
2014,Septiembre,9,9/1/2014,Antigua y Barbuda,1,7,0,8
2014,Septiembre,9,9/1/2014,Países Bajos,875,1615,0,2490
2014,Septiembre,9,9/1/2014,Arabia Saudita,2,10,0,12
2014,Septiembre,9,9/1/2014,Argelia,6,6,0,12
2014,Septiembre,9,9/1/2014,Argentina,4044,5563,0,9607
2014,Septiembre,9,9/1/2014,República de Armenia,3,2,0,5
2014,Septiembre,9,9/1/2014,Australia,385,656,0,1041
2014,Septiembre,9,9/1/2014,Austria,119,252,0,371
2014,Septiembre,9,9/1/2014,Azerbaiyán,0,2,0,2
2014,Septiembre,9,9/1/2014,Bahamas,5,4,0,9
2014,Septiembre,9,9/1/2014,Bangladesh,0,12,0,12
2014,Septiembre,9,9/1/2014,Barbados,3,7,0,10
2014,Septiembre,9,9/1/2014,República de Belarús,6,0,0,6
2014,Septiembre,9,9/1/2014,Bélgica,134,367,0,501
2014,Septiembre,9,9/1/2014,Belice,6,10,0,16
2014,Septiembre,9,9/1/2014,Benín,1,0,0,1
2014,Septiembre,9,9/1/2014,Bermudas/Territorio Británico de Ultramar,0,2,0,2
2014,Septiembre,9,9/1/2014,Bolivia,510,633,0,1143
2014,Septiembre,9,9/1/2014,Botsuana,2,2,0,4
2014,Septiembre,9,9/1/2014,Brasil,5866,7038,0,12904
2014,Septiembre,9,9/1/2014,Bulgaria,14,28,0,42
2014,Septiembre,9,9/1/2014,Burkina Faso,0,1,0,1
2014,Septiembre,9,9/1/2014,Bután,0,1,0,1
2014,Septiembre,9,9/1/2014,Cabo Verde,0,1,0,1
2014,Septiembre,9,9/1/2014,Islas Caimán/Territorio Británico de Ultramar,4,2,0,6
2014,Septiembre,9,9/1/2014,Camboya,1,0,0,1
2014,Septiembre,9,9/1/2014,Camerún,0,5,0,5
2014,Septiembre,9,9/1/2014,Canadá,718,1502,0,2220
2014,Septiembre,9,9/1/2014,España,2466,6294,0,8760
2014,Septiembre,9,9/1/2014,República Democrática del Congo,0,4,0,4
2014,Septiembre,9,9/1/2014,República de Corea,167,510,0,677
2014,Septiembre,9,9/1/2014,Costa de Marfil,0,6,0,6
2014,Septiembre,9,9/1/2014,Costa Rica,805,1301,0,2106
2014,Septiembre,9,9/1/2014,Croacia,9,45,0,54
2014,Septiembre,9,9/1/2014,Cuba,173,286,0,459
2014,Septiembre,9,9/1/2014,Curazao,0,1,0,1
2014,Septiembre,9,9/1/2014,República Checa,36,66,0,102
2014,Septiembre,9,9/1/2014,Chile,4479,5563,0,10042
2014,Septiembre,9,9/1/2014,China,205,544,0,749
2014,Septiembre,9,9/1/2014,Chipre,1,7,0,8
2014,Septiembre,9,9/1/2014,Dinamarca,51,136,0,187
2014,Septiembre,9,9/1/2014,Dominica,0,2,0,2
2014,Septiembre,9,9/1/2014,Ecuador,3919,6313,0,10232
2014,Septiembre,9,9/1/2014,Egipto,5,28,0,33
2014,Septiembre,9,9/1/2014,El Salvador,642,886,0,1528
2014,Septiembre,9,9/1/2014,Emiratos Árabes,0,5,0,5
2014,Septiembre,9,9/1/2014,Eslovaquia,22,34,0,56
2014,Septiembre,9,9/1/2014,Eslovenia,11,25,0,36
2014,Septiembre,9,9/1/2014,Estados Unidos de América,7142,15784,0,22926
2014,Septiembre,9,9/1/2014,Estonia,2,6,0,8
2014,Septiembre,9,9/1/2014,Etiopia,2,3,0,5
2014,Septiembre,9,9/1/2014,Islas Fiji,0,1,0,1
2014,Septiembre,9,9/1/2014,Filipinas,23,251,0,274
2014,Septiembre,9,9/1/2014,Finlandia,33,76,0,109
2014,Septiembre,9,9/1/2014,Francia,934,2014,0,2948
2014,Septiembre,9,9/1/2014,Georgia,9,27,0,36
2014,Septiembre,9,9/1/2014,Ghana,1,2,0,3
2014,Septiembre,9,9/1/2014,Granada,0,1,0,1
2014,Septiembre,9,9/1/2014,Grecia,26,67,0,93
2014,Septiembre,9,9/1/2014,Guatemala,355,789,0,1144
2014,Septiembre,9,9/1/2014,Guyana,3,12,0,15
2014,Septiembre,9,9/1/2014,Guinea Ecuatorial,3,0,0,3
2014,Septiembre,9,9/1/2014,Guinea Bissau,0,2,0,2
2014,Septiembre,9,9/1/2014,Haití,6,29,0,35
2014,Septiembre,9,9/1/2014,Honduras,233,397,0,630
2014,Septiembre,9,9/1/2014,Hong Kong,1,1,0,2
2014,Septiembre,9,9/1/2014,Hungría,16,36,0,52
2014,Septiembre,9,9/1/2014,India,39,344,0,383
2014,Septiembre,9,9/1/2014,Indonesia,5,37,0,42
2014,Septiembre,9,9/1/2014,Irán,4,17,0,21
2014,Septiembre,9,9/1/2014,República de Irlanda,110,217,0,327
2014,Septiembre,9,9/1/2014,Islandia,2,9,0,11
2014,Septiembre,9,9/1/2014,Israel,87,534,0,621
2014,Septiembre,9,9/1/2014,Italia,569,1888,0,2457
2014,Septiembre,9,9/1/2014,Jamaica,10,27,0,37
2014,Septiembre,9,9/1/2014,Japón,161,596,0,757
2014,Septiembre,9,9/1/2014,Jordania,1,3,0,4
2014,Septiembre,9,9/1/2014,Kazajistán,7,5,0,12
2014,Septiembre,9,9/1/2014,Kenia,13,26,0,39
2014,Septiembre,9,9/1/2014,Kuwait,1,1,0,2
2014,Septiembre,9,9/1/2014,República de Kosovo,0,1,0,1
2014,Septiembre,9,9/1/2014,República Democrática Popular  Lao,0,1,0,1
2014,Septiembre,9,9/1/2014,Letonia,3,5,0,8
2014,Septiembre,9,9/1/2014,Lituania,18,18,0,36
2014,Septiembre,9,9/1/2014,Líbano,23,31,0,54
2014,Septiembre,9,9/1/2014,Liechtenstein,1,1,0,2
2014,Septiembre,9,9/1/2014,Luxemburgo,3,8,0,11
2014,Septiembre,9,9/1/2014,Macedonia,1,0,0,1
2014,Septiembre,9,9/1/2014,Madagascar,0,1,0,1
2014,Septiembre,9,9/1/2014,Malasia,14,36,0,50
2014,Septiembre,9,9/1/2014,Malawi,0,1,0,1
2014,Septiembre,9,9/1/2014,Malí,3,0,0,3
2014,Septiembre,9,9/1/2014,Malta,3,5,0,8
2014,Septiembre,9,9/1/2014,Marruecos,11,6,0,17
2014,Septiembre,9,9/1/2014,Mauricio,0,1,0,1
2014,Septiembre,9,9/1/2014,Mauritania,1,0,0,1
2014,Septiembre,9,9/1/2014,México,3270,6626,0,9896
2014,Septiembre,9,9/1/2014,República de Moldavia,4,1,0,5
2014,Septiembre,9,9/1/2014,Mónaco,0,1,0,1
2014,Septiembre,9,9/1/2014,Mongolia,0,3,0,3
2014,Septiembre,9,9/1/2014,Mozambique,1,1,0,2
2014,Septiembre,9,9/1/2014,Myanmar,0,3,0,3
2014,Septiembre,9,9/1/2014,Namibia,1,1,0,2
2014,Septiembre,9,9/1/2014,Nepal,0,2,0,2
2014,Septiembre,9,9/1/2014,Nicaragua,79,110,0,189
2014,Septiembre,9,9/1/2014,Nigeria,1,11,0,12
2014,Septiembre,9,9/1/2014,Noruega,68,162,0,230
2014,Septiembre,9,9/1/2014,Nueva Zelanda,66,115,0,181
2014,Septiembre,9,9/1/2014,Omán,1,2,0,3
2014,Septiembre,9,9/1/2014,Pakistán,2,10,0,12
2014,Septiembre,9,9/1/2014,Panamá,1866,2338,0,4204
2014,Septiembre,9,9/1/2014,Paraguay,169,256,0,425
2014,Septiembre,9,9/1/2014,Perú,4793,5733,0,10526
2014,Septiembre,9,9/1/2014,Palestina,4,9,0,13
2014,Septiembre,9,9/1/2014,Polonia,111,179,0,290
2014,Septiembre,9,9/1/2014,Portugal,257,557,0,814
2014,Septiembre,9,9/1/2014,Reino Unido de Gran Bretaña e Irlanda del Norte,735,1741,0,2476
2014,Septiembre,9,9/1/2014,República CentroÁfricana,0,3,0,3
2014,Septiembre,9,9/1/2014,Federación de Rusia,168,204,0,372
2014,Septiembre,9,9/1/2014,República Dominicana,382,606,0,988
2014,Septiembre,9,9/1/2014,Rumania,48,82,0,130
2014,Septiembre,9,9/1/2014,San Cristóbal y Nevis,0,2,0,2
2014,Septiembre,9,9/1/2014,San  Vicente y las Granadinas,0,1,0,1
2014,Septiembre,9,9/1/2014,Santa Sede/Ciudad del Vaticano,0,1,0,1
2014,Septiembre,9,9/1/2014,Senegal,2,2,0,4
2014,Septiembre,9,9/1/2014,Serbia,11,4,0,15
2014,Septiembre,9,9/1/2014,Singapur,15,22,0,37
2014,Septiembre,9,9/1/2014,República Árabe Siria,1,1,0,2
2014,Septiembre,9,9/1/2014,Sri Lanka,0,4,0,4
2014,Septiembre,9,9/1/2014,Sudáfrica,34,100,0,134
2014,Septiembre,9,9/1/2014,Suecia,116,228,0,344
2014,Septiembre,9,9/1/2014,Suiza,283,551,0,834
2014,Septiembre,9,9/1/2014,Surinam,54,43,0,97
2014,Septiembre,9,9/1/2014,Suazilandia,0,1,0,1
2014,Septiembre,9,9/1/2014,Taiwán,61,104,0,165
2014,Septiembre,9,9/1/2014,Tailandia,5,11,0,16
2014,Septiembre,9,9/1/2014,Tanzania,1,10,0,11
2014,Septiembre,9,9/1/2014,Togo,0,2,0,2
2014,Septiembre,9,9/1/2014,Trinidad y Tobago,16,76,0,92
2014,Septiembre,9,9/1/2014,Túnez,1,2,0,3
2014,Septiembre,9,9/1/2014,Turquía,19,97,0,116
2014,Septiembre,9,9/1/2014,Ucrania,11,58,0,69
2014,Septiembre,9,9/1/2014,Uganda,1,7,0,8
2014,Septiembre,9,9/1/2014,Uruguay,385,601,0,986
2014,Septiembre,9,9/1/2014,Uzbekistán,2,0,0,2
2014,Septiembre,9,9/1/2014,Venezuela,11950,14449,0,26399
2014,Septiembre,9,9/1/2014,Vietnam,5,3,0,8
2014,Septiembre,9,9/1/2014,Islas Vírgenes Británicas/Territorio Británico de Ultramar,0,1,0,1
2014,Septiembre,9,9/1/2014,Zimbabue,3,4,0,7
2014,Septiembre,9,9/1/2014,Desconocido,51,99,0,150
2014,Octubre,10,10/1/2014,Albania,1,1,0,2
2014,Octubre,10,10/1/2014,Alemania,1472,2474,0,3946
2014,Octubre,10,10/1/2014,Andorra,1,11,0,12
2014,Octubre,10,10/1/2014,Angola,2,1,0,3
2014,Octubre,10,10/1/2014,Antigua y Barbuda,0,2,0,2
2014,Octubre,10,10/1/2014,Países Bajos,1124,1775,0,2899
2014,Octubre,10,10/1/2014,Arabia Saudita,0,7,0,7
2014,Octubre,10,10/1/2014,Argelia,2,6,0,8
2014,Octubre,10,10/1/2014,Argentina,3933,5562,0,9495
2014,Octubre,10,10/1/2014,República de Armenia,1,2,0,3
2014,Octubre,10,10/1/2014,Australia,312,629,0,941
2014,Octubre,10,10/1/2014,Austria,118,228,0,346
2014,Octubre,10,10/1/2014,Azerbaiyán,2,2,0,4
2014,Octubre,10,10/1/2014,Bahamas,1,7,0,8
2014,Octubre,10,10/1/2014,Bangladesh,0,5,0,5
2014,Octubre,10,10/1/2014,Barbados,2,3,0,5
2014,Octubre,10,10/1/2014,República de Belarús,1,6,0,7
2014,Octubre,10,10/1/2014,Bélgica,175,508,0,683
2014,Octubre,10,10/1/2014,Belice,5,16,0,21
2014,Octubre,10,10/1/2014,Benín,0,1,0,1
2014,Octubre,10,10/1/2014,Bermudas/Territorio Británico de Ultramar,0,3,0,3
2014,Octubre,10,10/1/2014,Bolivia,635,737,0,1372
2014,Octubre,10,10/1/2014,Bosnia y Herzegovina,2,1,0,3
2014,Octubre,10,10/1/2014,Brasil,5631,6655,0,12286
2014,Octubre,10,10/1/2014,Bulgaria,37,42,0,79
2014,Octubre,10,10/1/2014,Islas Caimán/Territorio Británico de Ultramar,1,1,0,2
2014,Octubre,10,10/1/2014,Camboya,1,0,0,1
2014,Octubre,10,10/1/2014,Camerún,1,5,0,6
2014,Octubre,10,10/1/2014,Canadá,868,1714,0,2582
2014,Octubre,10,10/1/2014,España,2628,6612,0,9240
2014,Octubre,10,10/1/2014,República Del Congo,0,1,0,1
2014,Octubre,10,10/1/2014,República Democrática del Congo,0,3,0,3
2014,Octubre,10,10/1/2014,República de Corea,237,649,0,886
2014,Octubre,10,10/1/2014,Costa Rica,746,1257,0,2003
2014,Octubre,10,10/1/2014,Croacia,7,35,0,42
2014,Octubre,10,10/1/2014,Cuba,188,365,0,553
2014,Octubre,10,10/1/2014,República Checa,50,72,0,122
2014,Octubre,10,10/1/2014,Chile,4069,5183,0,9252
2014,Octubre,10,10/1/2014,China,225,573,0,798
2014,Octubre,10,10/1/2014,Chipre,3,3,0,6
2014,Octubre,10,10/1/2014,Dinamarca,79,179,0,258
2014,Octubre,10,10/1/2014,República de Yibuti,0,1,0,1
2014,Octubre,10,10/1/2014,Dominica,4,3,0,7
2014,Octubre,10,10/1/2014,Ecuador,4485,7107,0,11592
2014,Octubre,10,10/1/2014,Egipto,3,19,0,22
2014,Octubre,10,10/1/2014,El Salvador,588,767,0,1355
2014,Octubre,10,10/1/2014,Emiratos Árabes,8,22,0,30
2014,Octubre,10,10/1/2014,Eslovaquia,16,18,0,34
2014,Octubre,10,10/1/2014,Eslovenia,9,21,0,30
2014,Octubre,10,10/1/2014,Estados Unidos de América,7757,16766,0,24523
2014,Octubre,10,10/1/2014,Estonia,25,22,0,47
2014,Octubre,10,10/1/2014,Etiopia,1,6,0,7
2014,Octubre,10,10/1/2014,Islas Fiji,4,11,0,15
2014,Octubre,10,10/1/2014,Filipinas,20,216,0,236
2014,Octubre,10,10/1/2014,Finlandia,51,99,0,150
2014,Octubre,10,10/1/2014,Francia,1266,2352,0,3618
2014,Octubre,10,10/1/2014,Georgia,2,2,0,4
2014,Octubre,10,10/1/2014,Ghana,7,16,0,23
2014,Octubre,10,10/1/2014,Granada,4,3,0,7
2014,Octubre,10,10/1/2014,Grecia,22,70,0,92
2014,Octubre,10,10/1/2014,Guatemala,389,975,0,1364
2014,Octubre,10,10/1/2014,Guyana,5,12,0,17
2014,Octubre,10,10/1/2014,Guinea,1,2,0,3
2014,Octubre,10,10/1/2014,Haití,17,36,0,53
2014,Octubre,10,10/1/2014,Honduras,250,451,0,701
2014,Octubre,10,10/1/2014,Hong Kong,1,0,0,1
2014,Octubre,10,10/1/2014,Hungría,27,37,0,64
2014,Octubre,10,10/1/2014,India,48,295,0,343
2014,Octubre,10,10/1/2014,Indonesia,18,37,0,55
2014,Octubre,10,10/1/2014,Iraq,1,1,0,2
2014,Octubre,10,10/1/2014,Irán,5,20,0,25
2014,Octubre,10,10/1/2014,República de Irlanda,74,198,0,272
2014,Octubre,10,10/1/2014,Islandia,7,7,0,14
2014,Octubre,10,10/1/2014,Israel,129,662,0,791
2014,Octubre,10,10/1/2014,Italia,581,2070,0,2651
2014,Octubre,10,10/1/2014,Jamaica,31,46,0,77
2014,Octubre,10,10/1/2014,Japón,142,583,0,725
2014,Octubre,10,10/1/2014,Jordania,2,5,0,7
2014,Octubre,10,10/1/2014,Kazajistán,2,4,0,6
2014,Octubre,10,10/1/2014,Kenia,7,11,0,18
2014,Octubre,10,10/1/2014,Kuwait,2,3,0,5
2014,Octubre,10,10/1/2014,República de Kosovo,1,1,0,2
2014,Octubre,10,10/1/2014,Letonia,10,19,0,29
2014,Octubre,10,10/1/2014,Lituania,14,23,0,37
2014,Octubre,10,10/1/2014,Líbano,17,36,0,53
2014,Octubre,10,10/1/2014,Liechtenstein,1,2,0,3
2014,Octubre,10,10/1/2014,Luxemburgo,2,7,0,9
2014,Octubre,10,10/1/2014,Madagascar,2,0,0,2
2014,Octubre,10,10/1/2014,Malasia,16,24,0,40
2014,Octubre,10,10/1/2014,Malta,1,9,0,10
2014,Octubre,10,10/1/2014,Marruecos,1,9,0,10
2014,Octubre,10,10/1/2014,Mauricio,0,1,0,1
2014,Octubre,10,10/1/2014,Mauritania,0,2,0,2
2014,Octubre,10,10/1/2014,México,3077,6621,0,9698
2014,Octubre,10,10/1/2014,República de Moldavia,1,0,0,1
2014,Octubre,10,10/1/2014,Mongolia,3,0,0,3
2014,Octubre,10,10/1/2014,Mozambique,1,2,0,3
2014,Octubre,10,10/1/2014,Myanmar,1,2,0,3
2014,Octubre,10,10/1/2014,Namibia,6,2,0,8
2014,Octubre,10,10/1/2014,Nepal,2,2,0,4
2014,Octubre,10,10/1/2014,Nicaragua,92,126,0,218
2014,Octubre,10,10/1/2014,Nigeria,4,21,0,25
2014,Octubre,10,10/1/2014,Níger,0,2,0,2
2014,Octubre,10,10/1/2014,Noruega,70,165,0,235
2014,Octubre,10,10/1/2014,Nueva Zelanda,63,129,0,192
2014,Octubre,10,10/1/2014,Omán,0,8,0,8
2014,Octubre,10,10/1/2014,Papúa Nueva Guinea,1,0,0,1
2014,Octubre,10,10/1/2014,Pakistán,3,5,0,8
2014,Octubre,10,10/1/2014,Panamá,1830,2590,0,4420
2014,Octubre,10,10/1/2014,Paraguay,260,247,0,507
2014,Octubre,10,10/1/2014,Perú,5637,6707,0,12344
2014,Octubre,10,10/1/2014,Palestina,2,1,0,3
2014,Octubre,10,10/1/2014,Polonia,160,238,0,398
2014,Octubre,10,10/1/2014,Portugal,253,629,0,882
2014,Octubre,10,10/1/2014,Qatar,0,1,0,1
2014,Octubre,10,10/1/2014,Reino Unido de Gran Bretaña e Irlanda del Norte,735,2082,0,2817
2014,Octubre,10,10/1/2014,Federación de Rusia,218,341,0,559
2014,Octubre,10,10/1/2014,República Dominicana,421,697,0,1118
2014,Octubre,10,10/1/2014,República Democrática Popular de Corea,0,1,0,1
2014,Octubre,10,10/1/2014,Rumania,41,77,0,118
2014,Octubre,10,10/1/2014,Rwanda,2,1,0,3
2014,Octubre,10,10/1/2014,Samoa Occidental,1,0,0,1
2014,Octubre,10,10/1/2014,San  Vicente y las Granadinas,2,1,0,3
2014,Octubre,10,10/1/2014,Santa Lucia,7,3,0,10
2014,Octubre,10,10/1/2014,Santa Sede/Ciudad del Vaticano,0,3,0,3
2014,Octubre,10,10/1/2014,Senegal,0,5,0,5
2014,Octubre,10,10/1/2014,Serbia,7,8,0,15
2014,Octubre,10,10/1/2014,Singapur,14,21,0,35
2014,Octubre,10,10/1/2014,República Árabe Siria,3,4,0,7
2014,Octubre,10,10/1/2014,Sri Lanka,3,6,0,9
2014,Octubre,10,10/1/2014,Sudáfrica,18,78,0,96
2014,Octubre,10,10/1/2014,Sudán,0,1,0,1
2014,Octubre,10,10/1/2014,Suecia,117,274,0,391
2014,Octubre,10,10/1/2014,Suiza,394,701,0,1095
2014,Octubre,10,10/1/2014,Surinam,20,24,0,44
2014,Octubre,10,10/1/2014,Taiwán,48,84,0,132
2014,Octubre,10,10/1/2014,Tailandia,12,17,0,29
2014,Octubre,10,10/1/2014,Tanzania,1,1,0,2
2014,Octubre,10,10/1/2014,Togo,0,2,0,2
2014,Octubre,10,10/1/2014,Trinidad y Tobago,54,114,0,168
2014,Octubre,10,10/1/2014,Túnez,1,3,0,4
2014,Octubre,10,10/1/2014,Turquía,31,124,0,155
2014,Octubre,10,10/1/2014,Ucrania,34,49,0,83
2014,Octubre,10,10/1/2014,Uganda,3,2,0,5
2014,Octubre,10,10/1/2014,Uruguay,400,645,0,1045
2014,Octubre,10,10/1/2014,Venezuela,11081,14619,0,25700
2014,Octubre,10,10/1/2014,Vietnam,1,0,0,1
2014,Octubre,10,10/1/2014,Zambia,2,1,0,3
2014,Octubre,10,10/1/2014,Zimbabue,3,2,0,5
2014,Octubre,10,10/1/2014,Desconocido,52,125,0,177
2014,Noviembre,11,11/1/2014,Albania,3,5,0,8
2014,Noviembre,11,11/1/2014,Alemania,1676,2887,0,4563
2014,Noviembre,11,11/1/2014,Andorra,1,10,0,11
2014,Noviembre,11,11/1/2014,Antigua y Barbuda,1,6,0,7
2014,Noviembre,11,11/1/2014,Países Bajos,1007,1730,0,2737
2014,Noviembre,11,11/1/2014,Arabia Saudita,0,7,0,7
2014,Noviembre,11,11/1/2014,Argelia,2,4,0,6
2014,Noviembre,11,11/1/2014,Argentina,4470,6071,0,10541
2014,Noviembre,11,11/1/2014,República de Armenia,0,2,0,2
2014,Noviembre,11,11/1/2014,Australia,439,762,0,1201
2014,Noviembre,11,11/1/2014,Austria,187,367,0,554
2014,Noviembre,11,11/1/2014,Azerbaiyán,2,0,0,2
2014,Noviembre,11,11/1/2014,Bahamas,9,8,0,17
2014,Noviembre,11,11/1/2014,Bangladesh,1,7,0,8
2014,Noviembre,11,11/1/2014,Barbados,8,7,0,15
2014,Noviembre,11,11/1/2014,República de Belarús,2,2,0,4
2014,Noviembre,11,11/1/2014,Bélgica,167,427,0,594
2014,Noviembre,11,11/1/2014,Belice,4,14,0,18
2014,Noviembre,11,11/1/2014,Benín,2,0,0,2
2014,Noviembre,11,11/1/2014,Bolivia,665,778,0,1443
2014,Noviembre,11,11/1/2014,Bosnia y Herzegovina,4,3,0,7
2014,Noviembre,11,11/1/2014,Botsuana,1,0,0,1
2014,Noviembre,11,11/1/2014,Brasil,5763,6995,0,12758
2014,Noviembre,11,11/1/2014,Bulgaria,18,31,0,49
2014,Noviembre,11,11/1/2014,Burundi,0,1,0,1
2014,Noviembre,11,11/1/2014,Islas Caimán/Territorio Británico de Ultramar,2,0,0,2
2014,Noviembre,11,11/1/2014,Camboya,0,2,0,2
2014,Noviembre,11,11/1/2014,Camerún,2,5,0,7
2014,Noviembre,11,11/1/2014,Canadá,1096,1997,0,3093
2014,Noviembre,11,11/1/2014,España,2923,7563,0,10486
2014,Noviembre,11,11/1/2014,República Del Congo,0,1,0,1
2014,Noviembre,11,11/1/2014,República Democrática del Congo,4,3,0,7
2014,Noviembre,11,11/1/2014,República de Corea,188,543,0,731
2014,Noviembre,11,11/1/2014,Costa de Marfil,0,4,0,4
2014,Noviembre,11,11/1/2014,Costa Rica,811,1418,0,2229
2014,Noviembre,11,11/1/2014,Croacia,13,74,0,87
2014,Noviembre,11,11/1/2014,Cuba,220,409,0,629
2014,Noviembre,11,11/1/2014,Curazao,0,1,0,1
2014,Noviembre,11,11/1/2014,República Checa,66,105,0,171
2014,Noviembre,11,11/1/2014,Chile,3731,5039,0,8770
2014,Noviembre,11,11/1/2014,China,261,779,0,1040
2014,Noviembre,11,11/1/2014,Chipre,0,8,0,8
2014,Noviembre,11,11/1/2014,Dinamarca,90,174,0,264
2014,Noviembre,11,11/1/2014,Dominica,2,3,0,5
2014,Noviembre,11,11/1/2014,Ecuador,4398,6344,0,10742
2014,Noviembre,11,11/1/2014,Egipto,4,20,0,24
2014,Noviembre,11,11/1/2014,El Salvador,603,799,0,1402
2014,Noviembre,11,11/1/2014,Emiratos Árabes,1,4,0,5
2014,Noviembre,11,11/1/2014,Eritrea,0,1,0,1
2014,Noviembre,11,11/1/2014,Eslovaquia,22,37,0,59
2014,Noviembre,11,11/1/2014,Eslovenia,10,33,0,43
2014,Noviembre,11,11/1/2014,Estados Unidos de América,9355,18826,0,28181
2014,Noviembre,11,11/1/2014,Estonia,4,10,0,14
2014,Noviembre,11,11/1/2014,Etiopia,0,2,0,2
2014,Noviembre,11,11/1/2014,Filipinas,44,204,0,248
2014,Noviembre,11,11/1/2014,Finlandia,66,124,0,190
2014,Noviembre,11,11/1/2014,Francia,1391,2575,0,3966
2014,Noviembre,11,11/1/2014,Gabón,1,0,0,1
2014,Noviembre,11,11/1/2014,Georgia,5,7,0,12
2014,Noviembre,11,11/1/2014,Ghana,2,5,0,7
2014,Noviembre,11,11/1/2014,Gibraltar/Territorio Británico de Ultramar,0,1,0,1
2014,Noviembre,11,11/1/2014,Granada,0,4,0,4
2014,Noviembre,11,11/1/2014,Grecia,14,65,0,79
2014,Noviembre,11,11/1/2014,Guatemala,425,869,0,1294
2014,Noviembre,11,11/1/2014,Guyana,4,16,0,20
2014,Noviembre,11,11/1/2014,Haití,13,16,0,29
2014,Noviembre,11,11/1/2014,Honduras,236,403,0,639
2014,Noviembre,11,11/1/2014,Hong Kong,0,1,0,1
2014,Noviembre,11,11/1/2014,Hungría,51,59,0,110
2014,Noviembre,11,11/1/2014,India,65,335,0,400
2014,Noviembre,11,11/1/2014,Indonesia,12,52,0,64
2014,Noviembre,11,11/1/2014,Iraq,0,1,0,1
2014,Noviembre,11,11/1/2014,Irán,2,28,0,30
2014,Noviembre,11,11/1/2014,República de Irlanda,83,203,0,286
2014,Noviembre,11,11/1/2014,Islandia,6,17,0,23
2014,Noviembre,11,11/1/2014,Israel,116,611,0,727
2014,Noviembre,11,11/1/2014,Italia,682,2369,0,3051
2014,Noviembre,11,11/1/2014,Jamaica,19,39,0,58
2014,Noviembre,11,11/1/2014,Japón,140,609,0,749
2014,Noviembre,11,11/1/2014,Jordania,1,5,0,6
2014,Noviembre,11,11/1/2014,Kazajistán,7,3,0,10
2014,Noviembre,11,11/1/2014,Kenia,10,16,0,26
2014,Noviembre,11,11/1/2014,Kirguistán,3,0,0,3
2014,Noviembre,11,11/1/2014,Kuwait,2,4,0,6
2014,Noviembre,11,11/1/2014,República de Kosovo,3,1,0,4
2014,Noviembre,11,11/1/2014,Letonia,22,30,0,52
2014,Noviembre,11,11/1/2014,Lituania,19,26,0,45
2014,Noviembre,11,11/1/2014,Líbano,13,36,0,49
2014,Noviembre,11,11/1/2014,Libia,0,2,0,2
2014,Noviembre,11,11/1/2014,Liechtenstein,3,4,0,7
2014,Noviembre,11,11/1/2014,Luxemburgo,4,11,0,15
2014,Noviembre,11,11/1/2014,Macedonia,2,2,0,4
2014,Noviembre,11,11/1/2014,Madagascar,1,1,0,2
2014,Noviembre,11,11/1/2014,Malasia,11,40,0,51
2014,Noviembre,11,11/1/2014,Malí,0,2,0,2
2014,Noviembre,11,11/1/2014,Malta,1,4,0,5
2014,Noviembre,11,11/1/2014,Marruecos,1,11,0,12
2014,Noviembre,11,11/1/2014,Islas Marshall,0,1,0,1
2014,Noviembre,11,11/1/2014,Mauricio,0,2,0,2
2014,Noviembre,11,11/1/2014,Mauritania,1,0,0,1
2014,Noviembre,11,11/1/2014,México,2970,6658,0,9628
2014,Noviembre,11,11/1/2014,República de Moldavia,1,0,0,1
2014,Noviembre,11,11/1/2014,Mongolia,2,0,0,2
2014,Noviembre,11,11/1/2014,Montenegro,0,3,0,3
2014,Noviembre,11,11/1/2014,Micronesia,0,1,0,1
2014,Noviembre,11,11/1/2014,Mozambique,0,1,0,1
2014,Noviembre,11,11/1/2014,Myanmar,1,7,0,8
2014,Noviembre,11,11/1/2014,Namibia,0,1,0,1
2014,Noviembre,11,11/1/2014,Nepal,2,3,0,5
2014,Noviembre,11,11/1/2014,Nicaragua,87,118,0,205
2014,Noviembre,11,11/1/2014,Nigeria,1,9,0,10
2014,Noviembre,11,11/1/2014,Noruega,83,192,0,275
2014,Noviembre,11,11/1/2014,Nueva Zelanda,61,140,0,201
2014,Noviembre,11,11/1/2014,Omán,0,4,0,4
2014,Noviembre,11,11/1/2014,Papúa Nueva Guinea,0,1,0,1
2014,Noviembre,11,11/1/2014,Pakistán,1,10,0,11
2014,Noviembre,11,11/1/2014,Panamá,2071,2450,0,4521
2014,Noviembre,11,11/1/2014,Paraguay,288,237,0,525
2014,Noviembre,11,11/1/2014,Perú,4404,5859,0,10263
2014,Noviembre,11,11/1/2014,Palestina,3,1,0,4
2014,Noviembre,11,11/1/2014,Polonia,160,241,0,401
2014,Noviembre,11,11/1/2014,Portugal,267,619,0,886
2014,Noviembre,11,11/1/2014,Puerto Rico/Territorio de Estados Unidos,1,0,0,1
2014,Noviembre,11,11/1/2014,Reino Unido de Gran Bretaña e Irlanda del Norte,920,2032,0,2952
2014,Noviembre,11,11/1/2014,República CentroÁfricana,1,0,0,1
2014,Noviembre,11,11/1/2014,Federación de Rusia,175,369,0,544
2014,Noviembre,11,11/1/2014,República Dominicana,470,781,0,1251
2014,Noviembre,11,11/1/2014,Rumania,50,89,0,139
2014,Noviembre,11,11/1/2014,Rwanda,0,1,0,1
2014,Noviembre,11,11/1/2014,San Cristóbal y Nevis,3,5,0,8
2014,Noviembre,11,11/1/2014,Samoa Occidental,2,0,0,2
2014,Noviembre,11,11/1/2014,San  Vicente y las Granadinas,1,6,0,7
2014,Noviembre,11,11/1/2014,Santa Lucia,5,9,0,14
2014,Noviembre,11,11/1/2014,Senegal,1,0,0,1
2014,Noviembre,11,11/1/2014,Serbia,4,9,0,13
2014,Noviembre,11,11/1/2014,Singapur,11,22,0,33
2014,Noviembre,11,11/1/2014,República Árabe Siria,0,3,0,3
2014,Noviembre,11,11/1/2014,Sri Lanka,0,5,0,5
2014,Noviembre,11,11/1/2014,Sudáfrica,25,101,0,126
2014,Noviembre,11,11/1/2014,Sudán,1,2,0,3
2014,Noviembre,11,11/1/2014,Suecia,226,324,0,550
2014,Noviembre,11,11/1/2014,Suiza,382,766,0,1148
2014,Noviembre,11,11/1/2014,Surinam,13,31,0,44
2014,Noviembre,11,11/1/2014,Taiwán,51,81,0,132
2014,Noviembre,11,11/1/2014,Tailandia,10,5,0,15
2014,Noviembre,11,11/1/2014,Tanzania,1,2,0,3
2014,Noviembre,11,11/1/2014,Togo,0,4,0,4
2014,Noviembre,11,11/1/2014,Trinidad y Tobago,33,74,0,107
2014,Noviembre,11,11/1/2014,Túnez,1,1,0,2
2014,Noviembre,11,11/1/2014,Turquía,37,172,0,209
2014,Noviembre,11,11/1/2014,Ucrania,26,30,0,56
2014,Noviembre,11,11/1/2014,Uganda,1,2,0,3
2014,Noviembre,11,11/1/2014,Uruguay,346,554,0,900
2014,Noviembre,11,11/1/2014,Uzbekistán,1,0,0,1
2014,Noviembre,11,11/1/2014,Venezuela,11477,14854,0,26331
2014,Noviembre,11,11/1/2014,Vietnam,6,20,0,26
2014,Noviembre,11,11/1/2014,República Árabe de Yemen,0,2,0,2
2014,Noviembre,11,11/1/2014,Zambia,1,0,0,1
2014,Noviembre,11,11/1/2014,Zimbabue,2,6,0,8
2014,Noviembre,11,11/1/2014,Anguila/Territorio Británico de Ultramar,1,0,0,1
2014,Noviembre,11,11/1/2014,Islas Turcas y Caicos/Territorio Británico de Ultramar,1,0,0,1
2014,Noviembre,11,11/1/2014,Desconocido,80,128,0,208
2014,Diciembre,12,12/1/2014,Afganistán,0,1,0,1
2014,Diciembre,12,12/1/2014,Albania,2,5,0,7
2014,Diciembre,12,12/1/2014,Alemania,2062,3136,0,5198
2014,Diciembre,12,12/1/2014,Andorra,2,9,0,11
2014,Diciembre,12,12/1/2014,Angola,1,1,0,2
2014,Diciembre,12,12/1/2014,Antigua y Barbuda,3,5,0,8
2014,Diciembre,12,12/1/2014,Países Bajos,1240,2239,0,3479
2014,Diciembre,12,12/1/2014,Arabia Saudita,2,22,0,24
2014,Diciembre,12,12/1/2014,Argelia,1,3,0,4
2014,Diciembre,12,12/1/2014,Argentina,3982,5794,0,9776
2014,Diciembre,12,12/1/2014,República de Armenia,1,1,0,2
2014,Diciembre,12,12/1/2014,Australia,671,1057,0,1728
2014,Diciembre,12,12/1/2014,Austria,181,310,0,491
2014,Diciembre,12,12/1/2014,Azerbaiyán,2,4,0,6
2014,Diciembre,12,12/1/2014,Bahamas,4,4,0,8
2014,Diciembre,12,12/1/2014,Bahréin,0,6,0,6
2014,Diciembre,12,12/1/2014,Bangladesh,0,6,0,6
2014,Diciembre,12,12/1/2014,Barbados,4,6,0,10
2014,Diciembre,12,12/1/2014,República de Belarús,9,8,0,17
2014,Diciembre,12,12/1/2014,Bélgica,224,501,0,725
2014,Diciembre,12,12/1/2014,Belice,3,13,0,16
2014,Diciembre,12,12/1/2014,Benín,1,1,0,2
2014,Diciembre,12,12/1/2014,Bermudas/Territorio Británico de Ultramar,0,3,0,3
2014,Diciembre,12,12/1/2014,Bolivia,734,685,0,1419
2014,Diciembre,12,12/1/2014,Bosnia y Herzegovina,0,2,0,2
2014,Diciembre,12,12/1/2014,Brasil,5921,6286,0,12207
2014,Diciembre,12,12/1/2014,Bulgaria,13,19,0,32
2014,Diciembre,12,12/1/2014,Bután,0,1,0,1
2014,Diciembre,12,12/1/2014,Islas Caimán/Territorio Británico de Ultramar,3,8,0,11
2014,Diciembre,12,12/1/2014,Camerún,0,1,0,1
2014,Diciembre,12,12/1/2014,Canadá,2343,3592,0,5935
2014,Diciembre,12,12/1/2014,España,3107,6366,0,9473
2014,Diciembre,12,12/1/2014,República Del Congo,0,1,0,1
2014,Diciembre,12,12/1/2014,República Democrática del Congo,2,1,0,3
2014,Diciembre,12,12/1/2014,República de Corea,240,453,0,693
2014,Diciembre,12,12/1/2014,Costa de Marfil,0,4,0,4
2014,Diciembre,12,12/1/2014,Costa Rica,1657,1735,0,3392
2014,Diciembre,12,12/1/2014,Croacia,18,58,0,76
2014,Diciembre,12,12/1/2014,Cuba,259,466,0,725
2014,Diciembre,12,12/1/2014,Curazao,1,0,0,1
2014,Diciembre,12,12/1/2014,República Checa,44,54,0,98
2014,Diciembre,12,12/1/2014,Chile,3185,4328,0,7513
2014,Diciembre,12,12/1/2014,China,190,518,0,708
2014,Diciembre,12,12/1/2014,Chipre,5,7,0,12
2014,Diciembre,12,12/1/2014,Dinamarca,145,246,0,391
2014,Diciembre,12,12/1/2014,Dominica,2,2,0,4
2014,Diciembre,12,12/1/2014,Ecuador,5556,7877,0,13433
2014,Diciembre,12,12/1/2014,Egipto,6,16,0,22
2014,Diciembre,12,12/1/2014,El Salvador,554,706,0,1260
2014,Diciembre,12,12/1/2014,Emiratos Árabes,3,18,0,21
2014,Diciembre,12,12/1/2014,Eslovaquia,19,22,0,41
2014,Diciembre,12,12/1/2014,Eslovenia,20,21,0,41
2014,Diciembre,12,12/1/2014,Estados Unidos de América,17496,28436,0,45932
2014,Diciembre,12,12/1/2014,Estonia,26,21,0,47
2014,Diciembre,12,12/1/2014,Etiopia,3,1,0,4
2014,Diciembre,12,12/1/2014,Islas Fiji,1,1,0,2
2014,Diciembre,12,12/1/2014,Filipinas,28,208,0,236
2014,Diciembre,12,12/1/2014,Finlandia,103,117,0,220
2014,Diciembre,12,12/1/2014,Francia,1778,3007,0,4785
2014,Diciembre,12,12/1/2014,Georgia,2,2,0,4
2014,Diciembre,12,12/1/2014,Ghana,1,8,0,9
2014,Diciembre,12,12/1/2014,Granada,0,5,0,5
2014,Diciembre,12,12/1/2014,Grecia,35,82,0,117
2014,Diciembre,12,12/1/2014,Guatemala,457,706,0,1163
2014,Diciembre,12,12/1/2014,Guyana,1,16,0,17
2014,Diciembre,12,12/1/2014,Guinea,1,0,0,1
2014,Diciembre,12,12/1/2014,Guinea Ecuatorial,1,1,0,2
2014,Diciembre,12,12/1/2014,Haití,7,22,0,29
2014,Diciembre,12,12/1/2014,Honduras,233,311,0,544
2014,Diciembre,12,12/1/2014,Hong Kong,0,1,0,1
2014,Diciembre,12,12/1/2014,Hungría,33,46,0,79
2014,Diciembre,12,12/1/2014,India,78,265,0,343
2014,Diciembre,12,12/1/2014,Indonesia,10,48,0,58
2014,Diciembre,12,12/1/2014,Iraq,0,2,0,2
2014,Diciembre,12,12/1/2014,Irán,7,22,0,29
2014,Diciembre,12,12/1/2014,República de Irlanda,111,250,0,361
2014,Diciembre,12,12/1/2014,Islandia,19,25,0,44
2014,Diciembre,12,12/1/2014,Israel,94,541,0,635
2014,Diciembre,12,12/1/2014,Italia,914,2425,0,3339
2014,Diciembre,12,12/1/2014,Jamaica,18,94,0,112
2014,Diciembre,12,12/1/2014,Japón,227,499,0,726
2014,Diciembre,12,12/1/2014,Jordania,0,3,0,3
2014,Diciembre,12,12/1/2014,Kazajistán,7,6,0,13
2014,Diciembre,12,12/1/2014,Kenia,2,8,0,10
2014,Diciembre,12,12/1/2014,Kirguistán,0,5,0,5
2014,Diciembre,12,12/1/2014,Kuwait,0,4,0,4
2014,Diciembre,12,12/1/2014,República de Kosovo,1,0,0,1
2014,Diciembre,12,12/1/2014,Letonia,9,6,0,15
2014,Diciembre,12,12/1/2014,Lituania,21,30,0,51
2014,Diciembre,12,12/1/2014,Líbano,17,52,0,69
2014,Diciembre,12,12/1/2014,Liechtenstein,4,5,0,9
2014,Diciembre,12,12/1/2014,Luxemburgo,5,10,0,15
2014,Diciembre,12,12/1/2014,Macedonia,0,2,0,2
2014,Diciembre,12,12/1/2014,Madagascar,0,1,0,1
2014,Diciembre,12,12/1/2014,Malasia,24,39,0,63
2014,Diciembre,12,12/1/2014,Malta,2,7,0,9
2014,Diciembre,12,12/1/2014,Marruecos,5,20,0,25
2014,Diciembre,12,12/1/2014,Mauricio,2,2,0,4
2014,Diciembre,12,12/1/2014,México,3904,6210,0,10114
2014,Diciembre,12,12/1/2014,República de Moldavia,3,0,0,3
2014,Diciembre,12,12/1/2014,Mónaco,1,2,0,3
2014,Diciembre,12,12/1/2014,Mongolia,0,1,0,1
2014,Diciembre,12,12/1/2014,Montenegro,2,2,0,4
2014,Diciembre,12,12/1/2014,Myanmar,0,10,0,10
2014,Diciembre,12,12/1/2014,Namibia,1,0,0,1
2014,Diciembre,12,12/1/2014,Nepal,3,8,0,11
2014,Diciembre,12,12/1/2014,Nicaragua,72,107,0,179
2014,Diciembre,12,12/1/2014,Nigeria,2,10,0,12
2014,Diciembre,12,12/1/2014,Noruega,180,258,0,438
2014,Diciembre,12,12/1/2014,Nueva Zelanda,87,139,0,226
2014,Diciembre,12,12/1/2014,Pakistán,5,14,0,19
2014,Diciembre,12,12/1/2014,Panamá,1951,2781,0,4732
2014,Diciembre,12,12/1/2014,Paraguay,175,214,0,389
2014,Diciembre,12,12/1/2014,Perú,3970,5144,0,9114
2014,Diciembre,12,12/1/2014,Palestina,0,2,0,2
2014,Diciembre,12,12/1/2014,Polonia,169,223,0,392
2014,Diciembre,12,12/1/2014,Portugal,232,532,0,764
2014,Diciembre,12,12/1/2014,Puerto Rico/Territorio de Estados Unidos,1,0,0,1
2014,Diciembre,12,12/1/2014,Qatar,7,11,0,18
2014,Diciembre,12,12/1/2014,Reino Unido de Gran Bretaña e Irlanda del Norte,1208,2455,0,3663
2014,Diciembre,12,12/1/2014,República CentroÁfricana,0,1,0,1
2014,Diciembre,12,12/1/2014,Federación de Rusia,206,239,0,445
2014,Diciembre,12,12/1/2014,República Dominicana,373,605,0,978
2014,Diciembre,12,12/1/2014,Rumania,43,83,0,126
2014,Diciembre,12,12/1/2014,San Cristóbal y Nevis,1,3,0,4
2014,Diciembre,12,12/1/2014,Samoa Occidental,1,0,0,1
2014,Diciembre,12,12/1/2014,San Marino,0,1,0,1
2014,Diciembre,12,12/1/2014,San  Vicente y las Granadinas,2,5,0,7
2014,Diciembre,12,12/1/2014,Santa Lucia,6,5,0,11
2014,Diciembre,12,12/1/2014,Senegal,1,1,0,2
2014,Diciembre,12,12/1/2014,Serbia,18,10,0,28
2014,Diciembre,12,12/1/2014,Sierra Leona,0,1,0,1
2014,Diciembre,12,12/1/2014,Singapur,20,20,0,40
2014,Diciembre,12,12/1/2014,República Árabe Siria,0,2,0,2
2014,Diciembre,12,12/1/2014,Sri Lanka,0,2,0,2
2014,Diciembre,12,12/1/2014,Sudáfrica,43,66,0,109
2014,Diciembre,12,12/1/2014,Sudán,1,1,0,2
2014,Diciembre,12,12/1/2014,Suecia,439,590,0,1029
2014,Diciembre,12,12/1/2014,Suiza,569,1041,0,1610
2014,Diciembre,12,12/1/2014,Surinam,1,26,0,27
2014,Diciembre,12,12/1/2014,Taiwán,63,54,0,117
2014,Diciembre,12,12/1/2014,Tailandia,3,10,0,13
2014,Diciembre,12,12/1/2014,Tanzania,1,2,0,3
2014,Diciembre,12,12/1/2014,Togo,0,1,0,1
2014,Diciembre,12,12/1/2014,Trinidad y Tobago,32,81,0,113
2014,Diciembre,12,12/1/2014,Túnez,0,8,0,8
2014,Diciembre,12,12/1/2014,Turquía,52,124,0,176
2014,Diciembre,12,12/1/2014,Ucrania,19,28,0,47
2014,Diciembre,12,12/1/2014,Uganda,0,3,0,3
2014,Diciembre,12,12/1/2014,Uruguay,234,392,0,626
2014,Diciembre,12,12/1/2014,Uzbekistán,4,0,0,4
2014,Diciembre,12,12/1/2014,Vanuatu,0,1,0,1
2014,Diciembre,12,12/1/2014,Venezuela,18634,20870,0,39504
2014,Diciembre,12,12/1/2014,Vietnam,3,1,0,4
2014,Diciembre,12,12/1/2014,Islas Vírgenes Británicas/Territorio Británico de Ultramar,1,0,0,1
2014,Diciembre,12,12/1/2014,República Árabe de Yemen,0,1,0,1
2014,Diciembre,12,12/1/2014,Zambia,2,2,0,4
2014,Diciembre,12,12/1/2014,Zimbabue,2,2,0,4
2014,Diciembre,12,12/1/2014,Desconocido,44,73,0,117
2015,Enero,1,1/1/2015,Afganistán,1,0,0,1
2015,Enero,1,1/1/2015,Albania,1,2,0,3
2015,Enero,1,1/1/2015,Alemania,1900,2818,0,4718
2015,Enero,1,1/1/2015,Andorra,4,10,0,14
2015,Enero,1,1/1/2015,Angola,0,1,0,1
2015,Enero,1,1/1/2015,Antigua y Barbuda,1,7,0,8
2015,Enero,1,1/1/2015,Países Bajos,1003,1651,0,2654
2015,Enero,1,1/1/2015,Arabia Saudita,0,5,0,5
2015,Enero,1,1/1/2015,Argelia,3,5,0,8
2015,Enero,1,1/1/2015,Argentina,7474,7592,0,15066
2015,Enero,1,1/1/2015,República de Armenia,1,0,0,1
2015,Enero,1,1/1/2015,Australia,500,784,0,1284
2015,Enero,1,1/1/2015,Austria,166,330,0,496
2015,Enero,1,1/1/2015,Azerbaiyán,1,5,0,6
2015,Enero,1,1/1/2015,Bahamas,7,6,0,13
2015,Enero,1,1/1/2015,Bangladesh,0,9,0,9
2015,Enero,1,1/1/2015,Barbados,3,10,0,13
2015,Enero,1,1/1/2015,República de Belarús,16,11,0,27
2015,Enero,1,1/1/2015,Bélgica,219,441,0,660
2015,Enero,1,1/1/2015,Belice,1,5,0,6
2015,Enero,1,1/1/2015,Bermudas/Territorio Británico de Ultramar,0,3,0,3
2015,Enero,1,1/1/2015,Bolivia,748,800,0,1548
2015,Enero,1,1/1/2015,Bosnia y Herzegovina,1,3,0,4
2015,Enero,1,1/1/2015,Brasil,6264,6923,0,13187
2015,Enero,1,1/1/2015,Brunei Darussalam,1,0,0,1
2015,Enero,1,1/1/2015,Bulgaria,15,30,0,45
2015,Enero,1,1/1/2015,Burkina Faso,0,1,0,1
2015,Enero,1,1/1/2015,Bután,0,1,0,1
2015,Enero,1,1/1/2015,Islas Caimán/Territorio Británico de Ultramar,0,5,0,5
2015,Enero,1,1/1/2015,Camerún,2,0,0,2
2015,Enero,1,1/1/2015,Canadá,2358,3135,0,5493
2015,Enero,1,1/1/2015,España,2802,6567,0,9369
2015,Enero,1,1/1/2015,República Democrática del Congo,2,2,0,4
2015,Enero,1,1/1/2015,República de Corea,364,581,0,945
2015,Enero,1,1/1/2015,Costa Rica,1275,1451,0,2726
2015,Enero,1,1/1/2015,Croacia,23,54,0,77
2015,Enero,1,1/1/2015,Cuba,241,378,0,619
2015,Enero,1,1/1/2015,Curazao,1,1,0,2
2015,Enero,1,1/1/2015,República Checa,66,127,0,193
2015,Enero,1,1/1/2015,Chile,4161,4954,0,9115
2015,Enero,1,1/1/2015,China,231,519,0,750
2015,Enero,1,1/1/2015,Chipre,1,6,0,7
2015,Enero,1,1/1/2015,Dinamarca,124,219,0,343
2015,Enero,1,1/1/2015,Dominica,1,1,0,2
2015,Enero,1,1/1/2015,Ecuador,3896,5880,0,9776
2015,Enero,1,1/1/2015,Egipto,7,33,0,40
2015,Enero,1,1/1/2015,El Salvador,590,777,0,1367
2015,Enero,1,1/1/2015,Emiratos Árabes,2,4,0,6
2015,Enero,1,1/1/2015,Eslovaquia,22,35,0,57
2015,Enero,1,1/1/2015,Eslovenia,38,48,0,86
2015,Enero,1,1/1/2015,Estados Unidos de América,9501,17803,0,27304
2015,Enero,1,1/1/2015,Estonia,18,22,0,40
2015,Enero,1,1/1/2015,Etiopia,0,3,0,3
2015,Enero,1,1/1/2015,Filipinas,33,276,0,309
2015,Enero,1,1/1/2015,Finlandia,88,111,0,199
2015,Enero,1,1/1/2015,Francia,1882,2958,0,4840
2015,Enero,1,1/1/2015,Georgia,1,3,0,4
2015,Enero,1,1/1/2015,Ghana,3,4,0,7
2015,Enero,1,1/1/2015,Grecia,21,86,0,107
2015,Enero,1,1/1/2015,Guatemala,323,757,0,1080
2015,Enero,1,1/1/2015,Guyana,4,17,0,21
2015,Enero,1,1/1/2015,Guayana Francesa/Departamento de Ultramar Francés,0,1,0,1
2015,Enero,1,1/1/2015,Haití,8,22,0,30
2015,Enero,1,1/1/2015,Honduras,202,317,0,519
2015,Enero,1,1/1/2015,Hong Kong,1,0,0,1
2015,Enero,1,1/1/2015,Hungría,35,60,0,95
2015,Enero,1,1/1/2015,India,45,353,0,398
2015,Enero,1,1/1/2015,Indonesia,12,27,0,39
2015,Enero,1,1/1/2015,Iraq,0,23,0,23
2015,Enero,1,1/1/2015,Irán,4,16,0,20
2015,Enero,1,1/1/2015,República de Irlanda,99,250,0,349
2015,Enero,1,1/1/2015,Islandia,15,16,0,31
2015,Enero,1,1/1/2015,Israel,131,661,0,792
2015,Enero,1,1/1/2015,Italia,1039,2797,0,3836
2015,Enero,1,1/1/2015,Jamaica,30,29,0,59
2015,Enero,1,1/1/2015,Islas Salomón,1,0,0,1
2015,Enero,1,1/1/2015,Japón,236,585,0,821
2015,Enero,1,1/1/2015,Jordania,1,3,0,4
2015,Enero,1,1/1/2015,Kazajistán,4,11,0,15
2015,Enero,1,1/1/2015,Kenia,4,7,0,11
2015,Enero,1,1/1/2015,Kirguistán,2,2,0,4
2015,Enero,1,1/1/2015,Kuwait,3,3,0,6
2015,Enero,1,1/1/2015,República de Kosovo,1,0,0,1
2015,Enero,1,1/1/2015,Letonia,7,16,0,23
2015,Enero,1,1/1/2015,Lituania,22,18,0,40
2015,Enero,1,1/1/2015,Líbano,22,24,0,46
2015,Enero,1,1/1/2015,Libia,1,1,0,2
2015,Enero,1,1/1/2015,Liechtenstein,3,0,0,3
2015,Enero,1,1/1/2015,Luxemburgo,8,10,0,18
2015,Enero,1,1/1/2015,Macedonia,2,1,0,3
2015,Enero,1,1/1/2015,Madagascar,1,1,0,2
2015,Enero,1,1/1/2015,Malasia,16,21,0,37
2015,Enero,1,1/1/2015,Malta,2,14,0,16
2015,Enero,1,1/1/2015,Marruecos,7,8,0,15
2015,Enero,1,1/1/2015,Mauricio,0,2,0,2
2015,Enero,1,1/1/2015,Mauritania,0,1,0,1
2015,Enero,1,1/1/2015,México,3154,6046,0,9200
2015,Enero,1,1/1/2015,República de Moldavia,5,0,0,5
2015,Enero,1,1/1/2015,Mónaco,0,1,0,1
2015,Enero,1,1/1/2015,Mongolia,3,0,0,3
2015,Enero,1,1/1/2015,Montenegro,1,4,0,5
2015,Enero,1,1/1/2015,Myanmar,0,4,0,4
2015,Enero,1,1/1/2015,Nepal,0,1,0,1
2015,Enero,1,1/1/2015,Nicaragua,68,95,0,163
2015,Enero,1,1/1/2015,Nigeria,3,8,0,11
2015,Enero,1,1/1/2015,Noruega,140,211,0,351
2015,Enero,1,1/1/2015,Nueva Zelanda,74,117,0,191
2015,Enero,1,1/1/2015,Omán,0,1,0,1
2015,Enero,1,1/1/2015,Pakistán,2,10,0,12
2015,Enero,1,1/1/2015,Panamá,1770,2292,0,4062
2015,Enero,1,1/1/2015,Paraguay,308,244,0,552
2015,Enero,1,1/1/2015,Perú,4610,5807,0,10417
2015,Enero,1,1/1/2015,Palestina,1,3,0,4
2015,Enero,1,1/1/2015,Polonia,172,268,0,440
2015,Enero,1,1/1/2015,Portugal,300,644,0,944
2015,Enero,1,1/1/2015,Reino Unido de Gran Bretaña e Irlanda del Norte,1087,2173,0,3260
2015,Enero,1,1/1/2015,República CentroÁfricana,1,0,0,1
2015,Enero,1,1/1/2015,Federación de Rusia,392,516,0,908
2015,Enero,1,1/1/2015,República Dominicana,342,578,0,920
2015,Enero,1,1/1/2015,Rumania,52,61,0,113
2015,Enero,1,1/1/2015,San Cristóbal y Nevis,0,2,0,2
2015,Enero,1,1/1/2015,Samoa Occidental,1,0,0,1
2015,Enero,1,1/1/2015,San Marino,2,1,0,3
2015,Enero,1,1/1/2015,San  Vicente y las Granadinas,2,2,0,4
2015,Enero,1,1/1/2015,Santa Lucia,0,1,0,1
2015,Enero,1,1/1/2015,Santa Sede/Ciudad del Vaticano,0,1,0,1
2015,Enero,1,1/1/2015,Serbia,13,25,0,38
2015,Enero,1,1/1/2015,Sierra Leona,1,0,0,1
2015,Enero,1,1/1/2015,Singapur,19,30,0,49
2015,Enero,1,1/1/2015,República Árabe Siria,2,4,0,6
2015,Enero,1,1/1/2015,Sri Lanka,0,5,0,5
2015,Enero,1,1/1/2015,Sudáfrica,45,78,0,123
2015,Enero,1,1/1/2015,Suecia,333,485,0,818
2015,Enero,1,1/1/2015,Suiza,564,845,0,1409
2015,Enero,1,1/1/2015,Surinam,10,28,0,38
2015,Enero,1,1/1/2015,Taiwán,67,99,0,166
2015,Enero,1,1/1/2015,Tailandia,4,7,0,11
2015,Enero,1,1/1/2015,Tanzania,0,2,0,2
2015,Enero,1,1/1/2015,Togo,0,1,0,1
2015,Enero,1,1/1/2015,Trinidad y Tobago,20,83,0,103
2015,Enero,1,1/1/2015,Túnez,2,0,0,2
2015,Enero,1,1/1/2015,Turquía,48,170,0,218
2015,Enero,1,1/1/2015,Ucrania,42,76,0,118
2015,Enero,1,1/1/2015,Uganda,1,1,0,2
2015,Enero,1,1/1/2015,Uruguay,421,521,0,942
2015,Enero,1,1/1/2015,Uzbekistán,3,3,0,6
2015,Enero,1,1/1/2015,Venezuela,12775,15378,0,28153
2015,Enero,1,1/1/2015,Vietnam,0,1,0,1
2015,Enero,1,1/1/2015,Zimbabue,0,2,0,2
2015,Enero,1,1/1/2015,Desconocido,33,70,0,103
2015,Febrero,2,2/1/2015,Afganistán,0,1,0,1
2015,Febrero,2,2/1/2015,Albania,2,7,0,9
2015,Febrero,2,2/1/2015,Alemania,1873,3040,0,4913
2015,Febrero,2,2/1/2015,Andorra,2,12,0,14
2015,Febrero,2,2/1/2015,Angola,0,3,0,3
2015,Febrero,2,2/1/2015,Antigua y Barbuda,0,9,0,9
2015,Febrero,2,2/1/2015,Países Bajos,1023,1668,0,2691
2015,Febrero,2,2/1/2015,Arabia Saudita,0,4,0,4
2015,Febrero,2,2/1/2015,Argelia,1,3,0,4
2015,Febrero,2,2/1/2015,Argentina,5839,6754,0,12593
2015,Febrero,2,2/1/2015,República de Armenia,0,1,0,1
2015,Febrero,2,2/1/2015,Australia,366,606,0,972
2015,Febrero,2,2/1/2015,Austria,195,359,0,554
2015,Febrero,2,2/1/2015,Azerbaiyán,1,2,0,3
2015,Febrero,2,2/1/2015,Bahamas,3,14,0,17
2015,Febrero,2,2/1/2015,Bahréin,0,1,0,1
2015,Febrero,2,2/1/2015,Bangladesh,0,3,0,3
2015,Febrero,2,2/1/2015,Barbados,3,9,0,12
2015,Febrero,2,2/1/2015,República de Belarús,4,1,0,5
2015,Febrero,2,2/1/2015,Bélgica,181,416,0,597
2015,Febrero,2,2/1/2015,Belice,1,15,0,16
2015,Febrero,2,2/1/2015,Benín,1,0,0,1
2015,Febrero,2,2/1/2015,Bermudas/Territorio Británico de Ultramar,0,5,0,5
2015,Febrero,2,2/1/2015,Bolivia,381,532,0,913
2015,Febrero,2,2/1/2015,Bosnia y Herzegovina,1,2,0,3
2015,Febrero,2,2/1/2015,Botsuana,0,1,0,1
2015,Febrero,2,2/1/2015,Brasil,6180,6893,0,13073
2015,Febrero,2,2/1/2015,Bulgaria,18,33,0,51
2015,Febrero,2,2/1/2015,Burundi,0,1,0,1
2015,Febrero,2,2/1/2015,Islas Caimán/Territorio Británico de Ultramar,2,3,0,5
2015,Febrero,2,2/1/2015,Camerún,0,10,0,10
2015,Febrero,2,2/1/2015,Canadá,2311,3016,0,5327
2015,Febrero,2,2/1/2015,España,2222,6022,0,8244
2015,Febrero,2,2/1/2015,República Democrática del Congo,3,7,0,10
2015,Febrero,2,2/1/2015,República de Corea,242,439,0,681
2015,Febrero,2,2/1/2015,Costa de Marfil,2,1,0,3
2015,Febrero,2,2/1/2015,Costa Rica,698,1055,0,1753
2015,Febrero,2,2/1/2015,Croacia,14,45,0,59
2015,Febrero,2,2/1/2015,Cuba,183,330,0,513
2015,Febrero,2,2/1/2015,República Checa,41,75,0,116
2015,Febrero,2,2/1/2015,Chile,6040,6475,0,12515
2015,Febrero,2,2/1/2015,China,201,400,0,601
2015,Febrero,2,2/1/2015,Chipre,0,3,0,3
2015,Febrero,2,2/1/2015,Dinamarca,132,228,0,360
2015,Febrero,2,2/1/2015,Dominica,2,4,0,6
2015,Febrero,2,2/1/2015,Ecuador,5033,6576,0,11609
2015,Febrero,2,2/1/2015,Egipto,8,37,0,45
2015,Febrero,2,2/1/2015,El Salvador,596,844,0,1440
2015,Febrero,2,2/1/2015,Emiratos Árabes,3,3,0,6
2015,Febrero,2,2/1/2015,Eritrea,2,3,0,5
2015,Febrero,2,2/1/2015,Eslovaquia,30,26,0,56
2015,Febrero,2,2/1/2015,Eslovenia,16,31,0,47
2015,Febrero,2,2/1/2015,Estados Unidos de América,10912,20106,0,31018
2015,Febrero,2,2/1/2015,Estonia,39,35,0,74
2015,Febrero,2,2/1/2015,Etiopia,2,5,0,7
2015,Febrero,2,2/1/2015,Islas Fiji,0,1,0,1
2015,Febrero,2,2/1/2015,Filipinas,18,235,0,253
2015,Febrero,2,2/1/2015,Finlandia,81,118,0,199
2015,Febrero,2,2/1/2015,Francia,1725,2888,0,4613
2015,Febrero,2,2/1/2015,Georgia,0,1,0,1
2015,Febrero,2,2/1/2015,Ghana,2,10,0,12
2015,Febrero,2,2/1/2015,Granada,1,1,0,2
2015,Febrero,2,2/1/2015,Grecia,41,88,0,129
2015,Febrero,2,2/1/2015,Guatemala,411,893,0,1304
2015,Febrero,2,2/1/2015,Guyana,5,8,0,13
2015,Febrero,2,2/1/2015,Haití,3,22,0,25
2015,Febrero,2,2/1/2015,Honduras,207,332,0,539
2015,Febrero,2,2/1/2015,Hungría,37,56,0,93
2015,Febrero,2,2/1/2015,India,53,360,0,413
2015,Febrero,2,2/1/2015,Indonesia,18,47,0,65
2015,Febrero,2,2/1/2015,Iraq,0,3,0,3
2015,Febrero,2,2/1/2015,Irán,5,13,0,18
2015,Febrero,2,2/1/2015,República de Irlanda,95,197,0,292
2015,Febrero,2,2/1/2015,Islandia,14,13,0,27
2015,Febrero,2,2/1/2015,Israel,109,633,0,742
2015,Febrero,2,2/1/2015,Italia,955,2609,0,3564
2015,Febrero,2,2/1/2015,Jamaica,29,50,0,79
2015,Febrero,2,2/1/2015,Japón,177,626,0,803
2015,Febrero,2,2/1/2015,Jordania,2,7,0,9
2015,Febrero,2,2/1/2015,Kazajistán,9,5,0,14
2015,Febrero,2,2/1/2015,Kenia,1,8,0,9
2015,Febrero,2,2/1/2015,Kirguistán,0,4,0,4
2015,Febrero,2,2/1/2015,Kuwait,0,1,0,1
2015,Febrero,2,2/1/2015,República de Kosovo,1,2,0,3
2015,Febrero,2,2/1/2015,Letonia,10,11,0,21
2015,Febrero,2,2/1/2015,Lituania,27,24,0,51
2015,Febrero,2,2/1/2015,Líbano,24,32,0,56
2015,Febrero,2,2/1/2015,Liberia,1,0,0,1
2015,Febrero,2,2/1/2015,Liechtenstein,1,0,0,1
2015,Febrero,2,2/1/2015,Luxemburgo,5,10,0,15
2015,Febrero,2,2/1/2015,Macedonia,1,2,0,3
2015,Febrero,2,2/1/2015,Madagascar,2,0,0,2
2015,Febrero,2,2/1/2015,Malasia,12,14,0,26
2015,Febrero,2,2/1/2015,Malawi,1,0,0,1
2015,Febrero,2,2/1/2015,Malta,5,4,0,9
2015,Febrero,2,2/1/2015,Marruecos,8,15,0,23
2015,Febrero,2,2/1/2015,México,3124,6315,0,9439
2015,Febrero,2,2/1/2015,República de Moldavia,2,1,0,3
2015,Febrero,2,2/1/2015,Mongolia,1,1,0,2
2015,Febrero,2,2/1/2015,Myanmar,0,2,0,2
2015,Febrero,2,2/1/2015,Namibia,0,2,0,2
2015,Febrero,2,2/1/2015,Nepal,1,1,0,2
2015,Febrero,2,2/1/2015,Nicaragua,87,100,0,187
2015,Febrero,2,2/1/2015,Nigeria,3,5,0,8
2015,Febrero,2,2/1/2015,Noruega,119,188,0,307
2015,Febrero,2,2/1/2015,Nueva Zelanda,46,89,0,135
2015,Febrero,2,2/1/2015,Pakistán,3,12,0,15
2015,Febrero,2,2/1/2015,Panamá,2587,2849,0,5436
2015,Febrero,2,2/1/2015,Paraguay,376,307,0,683
2015,Febrero,2,2/1/2015,Perú,6275,6699,0,12974
2015,Febrero,2,2/1/2015,Palestina,0,2,0,2
2015,Febrero,2,2/1/2015,Polonia,207,330,0,537
2015,Febrero,2,2/1/2015,Portugal,230,537,0,767
2015,Febrero,2,2/1/2015,Qatar,0,1,0,1
2015,Febrero,2,2/1/2015,Reino Unido de Gran Bretaña e Irlanda del Norte,1051,2159,0,3210
2015,Febrero,2,2/1/2015,Federación de Rusia,182,217,0,399
2015,Febrero,2,2/1/2015,República Dominicana,408,656,0,1064
2015,Febrero,2,2/1/2015,Rumania,55,81,0,136
2015,Febrero,2,2/1/2015,Rwanda,2,1,0,3
2015,Febrero,2,2/1/2015,San Cristóbal y Nevis,2,6,0,8
2015,Febrero,2,2/1/2015,San  Vicente y las Granadinas,2,0,0,2
2015,Febrero,2,2/1/2015,Santa Lucia,5,1,0,6
2015,Febrero,2,2/1/2015,Serbia,5,12,0,17
2015,Febrero,2,2/1/2015,Singapur,9,9,0,18
2015,Febrero,2,2/1/2015,República Árabe Siria,1,2,0,3
2015,Febrero,2,2/1/2015,Sri Lanka,0,3,0,3
2015,Febrero,2,2/1/2015,Sudáfrica,42,85,0,127
2015,Febrero,2,2/1/2015,Sudán,0,1,0,1
2015,Febrero,2,2/1/2015,Suecia,243,342,0,585
2015,Febrero,2,2/1/2015,Suiza,562,832,0,1394
2015,Febrero,2,2/1/2015,Surinam,14,25,0,39
2015,Febrero,2,2/1/2015,Taiwán,73,67,0,140
2015,Febrero,2,2/1/2015,Tailandia,9,4,0,13
2015,Febrero,2,2/1/2015,Tanzania,1,5,0,6
2015,Febrero,2,2/1/2015,República Democrática de Timor Oriental,0,1,0,1
2015,Febrero,2,2/1/2015,Togo,0,4,0,4
2015,Febrero,2,2/1/2015,Trinidad y Tobago,35,96,0,131
2015,Febrero,2,2/1/2015,Túnez,1,8,0,9
2015,Febrero,2,2/1/2015,Turquía,73,323,0,396
2015,Febrero,2,2/1/2015,Ucrania,30,37,0,67
2015,Febrero,2,2/1/2015,Uganda,3,1,0,4
2015,Febrero,2,2/1/2015,Uruguay,360,542,0,902
2015,Febrero,2,2/1/2015,Venezuela,9998,12646,0,22644
2015,Febrero,2,2/1/2015,Vietnam,7,9,0,16
2015,Febrero,2,2/1/2015,República Árabe de Yemen,0,1,0,1
2015,Febrero,2,2/1/2015,Zambia,1,2,0,3
2015,Febrero,2,2/1/2015,Zimbabue,2,3,0,5
2015,Febrero,2,2/1/2015,Desconocido,42,82,0,124
2015,Marzo,3,3/1/2015,Albania,2,10,0,12
2015,Marzo,3,3/1/2015,Alemania,2160,3288,0,5448
2015,Marzo,3,3/1/2015,Andorra,3,15,0,18
2015,Marzo,3,3/1/2015,Angola,0,1,0,1
2015,Marzo,3,3/1/2015,Antigua y Barbuda,3,6,0,9
2015,Marzo,3,3/1/2015,Países Bajos,1039,1718,0,2757
2015,Marzo,3,3/1/2015,Arabia Saudita,0,11,0,11
2015,Marzo,3,3/1/2015,Argelia,1,4,0,5
2015,Marzo,3,3/1/2015,Argentina,6367,7649,0,14016
2015,Marzo,3,3/1/2015,República de Armenia,4,5,0,9
2015,Marzo,3,3/1/2015,Australia,331,640,0,971
2015,Marzo,3,3/1/2015,Austria,150,328,0,478
2015,Marzo,3,3/1/2015,Azerbaiyán,2,3,0,5
2015,Marzo,3,3/1/2015,Bahamas,3,16,0,19
2015,Marzo,3,3/1/2015,Bahréin,0,2,0,2
2015,Marzo,3,3/1/2015,Bangladesh,0,12,0,12
2015,Marzo,3,3/1/2015,Barbados,4,8,0,12
2015,Marzo,3,3/1/2015,República de Belarús,5,9,0,14
2015,Marzo,3,3/1/2015,Bélgica,157,427,0,584
2015,Marzo,3,3/1/2015,Belice,7,19,0,26
2015,Marzo,3,3/1/2015,Benín,2,1,0,3
2015,Marzo,3,3/1/2015,Bermudas/Territorio Británico de Ultramar,2,1,0,3
2015,Marzo,3,3/1/2015,Bolivia,367,493,0,860
2015,Marzo,3,3/1/2015,Bosnia y Herzegovina,0,2,0,2
2015,Marzo,3,3/1/2015,Brasil,4864,6403,0,11267
2015,Marzo,3,3/1/2015,Bulgaria,25,28,0,53
2015,Marzo,3,3/1/2015,Burkina Faso,0,1,0,1
2015,Marzo,3,3/1/2015,Burundi,0,2,0,2
2015,Marzo,3,3/1/2015,Cabo Verde,1,0,0,1
2015,Marzo,3,3/1/2015,Islas Caimán/Territorio Británico de Ultramar,3,2,0,5
2015,Marzo,3,3/1/2015,Camerún,1,1,0,2
2015,Marzo,3,3/1/2015,Canadá,1998,2792,0,4790
2015,Marzo,3,3/1/2015,Chad,0,1,0,1
2015,Marzo,3,3/1/2015,España,2782,6601,0,9383
2015,Marzo,3,3/1/2015,República de Corea,201,562,0,763
2015,Marzo,3,3/1/2015,Costa de Marfil,0,2,0,2
2015,Marzo,3,3/1/2015,Costa Rica,1002,1393,0,2395
2015,Marzo,3,3/1/2015,Croacia,14,44,0,58
2015,Marzo,3,3/1/2015,Cuba,219,376,0,595
2015,Marzo,3,3/1/2015,República Checa,46,94,0,140
2015,Marzo,3,3/1/2015,Chile,4088,5521,0,9609
2015,Marzo,3,3/1/2015,China,247,755,0,1002
2015,Marzo,3,3/1/2015,Chipre,3,3,0,6
2015,Marzo,3,3/1/2015,Dinamarca,115,229,0,344
2015,Marzo,3,3/1/2015,Dominica,2,2,0,4
2015,Marzo,3,3/1/2015,Ecuador,4909,7683,0,12592
2015,Marzo,3,3/1/2015,Egipto,4,25,0,29
2015,Marzo,3,3/1/2015,El Salvador,682,908,0,1590
2015,Marzo,3,3/1/2015,Emiratos Árabes,0,28,0,28
2015,Marzo,3,3/1/2015,Eslovaquia,40,27,0,67
2015,Marzo,3,3/1/2015,Eslovenia,12,35,0,47
2015,Marzo,3,3/1/2015,Estados Unidos de América,12738,22622,0,35360
2015,Marzo,3,3/1/2015,Estonia,15,12,0,27
2015,Marzo,3,3/1/2015,Etiopia,1,0,0,1
2015,Marzo,3,3/1/2015,Filipinas,26,336,0,362
2015,Marzo,3,3/1/2015,Finlandia,70,129,0,199
2015,Marzo,3,3/1/2015,Francia,1380,2468,0,3848
2015,Marzo,3,3/1/2015,Georgia,4,13,0,17
2015,Marzo,3,3/1/2015,Ghana,2,9,0,11
2015,Marzo,3,3/1/2015,Granada,0,2,0,2
2015,Marzo,3,3/1/2015,Grecia,25,81,0,106
2015,Marzo,3,3/1/2015,Guatemala,476,985,0,1461
2015,Marzo,3,3/1/2015,Guyana,7,13,0,20
2015,Marzo,3,3/1/2015,Guinea,0,1,0,1
2015,Marzo,3,3/1/2015,Guinea Ecuatorial,2,4,0,6
2015,Marzo,3,3/1/2015,Haití,6,13,0,19
2015,Marzo,3,3/1/2015,Honduras,302,428,0,730
2015,Marzo,3,3/1/2015,Hong Kong,0,1,0,1
2015,Marzo,3,3/1/2015,Hungría,41,51,0,92
2015,Marzo,3,3/1/2015,India,60,439,0,499
2015,Marzo,3,3/1/2015,Indonesia,7,26,0,33
2015,Marzo,3,3/1/2015,Iraq,0,1,0,1
2015,Marzo,3,3/1/2015,Irán,3,10,0,13
2015,Marzo,3,3/1/2015,República de Irlanda,117,236,0,353
2015,Marzo,3,3/1/2015,Islandia,10,15,0,25
2015,Marzo,3,3/1/2015,Israel,226,921,0,1147
2015,Marzo,3,3/1/2015,Italia,936,2479,0,3415
2015,Marzo,3,3/1/2015,Jamaica,12,34,0,46
2015,Marzo,3,3/1/2015,Japón,218,621,0,839
2015,Marzo,3,3/1/2015,Jordania,2,6,0,8
2015,Marzo,3,3/1/2015,Kazajistán,7,5,0,12
2015,Marzo,3,3/1/2015,Kenia,1,15,0,16
2015,Marzo,3,3/1/2015,Kirguistán,0,5,0,5
2015,Marzo,3,3/1/2015,Kuwait,2,3,0,5
2015,Marzo,3,3/1/2015,Letonia,14,13,0,27
2015,Marzo,3,3/1/2015,Lituania,15,16,0,31
2015,Marzo,3,3/1/2015,Líbano,14,42,0,56
2015,Marzo,3,3/1/2015,Liberia,1,0,0,1
2015,Marzo,3,3/1/2015,Liechtenstein,2,7,0,9
2015,Marzo,3,3/1/2015,Luxemburgo,8,8,0,16
2015,Marzo,3,3/1/2015,Macedonia,0,5,0,5
2015,Marzo,3,3/1/2015,Malasia,14,37,0,51
2015,Marzo,3,3/1/2015,Malí,1,1,0,2
2015,Marzo,3,3/1/2015,Malta,2,8,0,10
2015,Marzo,3,3/1/2015,Marruecos,4,11,0,15
2015,Marzo,3,3/1/2015,Mauricio,0,1,0,1
2015,Marzo,3,3/1/2015,México,4194,7880,0,12074
2015,Marzo,3,3/1/2015,República de Moldavia,5,0,0,5
2015,Marzo,3,3/1/2015,Mónaco,1,1,0,2
2015,Marzo,3,3/1/2015,Mongolia,1,2,0,3
2015,Marzo,3,3/1/2015,Montenegro,0,2,0,2
2015,Marzo,3,3/1/2015,Mozambique,0,1,0,1
2015,Marzo,3,3/1/2015,Myanmar,0,2,0,2
2015,Marzo,3,3/1/2015,Nepal,0,1,0,1
2015,Marzo,3,3/1/2015,Nicaragua,67,115,0,182
2015,Marzo,3,3/1/2015,Nigeria,5,10,0,15
2015,Marzo,3,3/1/2015,Noruega,175,209,0,384
2015,Marzo,3,3/1/2015,Nueva Zelanda,66,101,0,167
2015,Marzo,3,3/1/2015,Papúa Nueva Guinea,0,3,0,3
2015,Marzo,3,3/1/2015,Pakistán,4,13,0,17
2015,Marzo,3,3/1/2015,Palau,2,0,0,2
2015,Marzo,3,3/1/2015,Panamá,1447,2084,0,3531
2015,Marzo,3,3/1/2015,Paraguay,299,228,0,527
2015,Marzo,3,3/1/2015,Perú,4820,6150,0,10970
2015,Marzo,3,3/1/2015,Polonia,160,250,0,410
2015,Marzo,3,3/1/2015,Portugal,284,569,0,853
2015,Marzo,3,3/1/2015,Puerto Rico/Territorio de Estados Unidos,0,1,0,1
2015,Marzo,3,3/1/2015,Qatar,1,6,0,7
2015,Marzo,3,3/1/2015,Reino Unido de Gran Bretaña e Irlanda del Norte,1126,2342,0,3468
2015,Marzo,3,3/1/2015,Federación de Rusia,197,306,0,503
2015,Marzo,3,3/1/2015,República Dominicana,387,606,0,993
2015,Marzo,3,3/1/2015,Rumania,47,88,0,135
2015,Marzo,3,3/1/2015,San Cristóbal y Nevis,0,1,0,1
2015,Marzo,3,3/1/2015,San Marino,0,2,0,2
2015,Marzo,3,3/1/2015,Santa Lucia,2,5,0,7
2015,Marzo,3,3/1/2015,Senegal,1,1,0,2
2015,Marzo,3,3/1/2015,Serbia,11,19,0,30
2015,Marzo,3,3/1/2015,Singapur,20,40,0,60
2015,Marzo,3,3/1/2015,República Árabe Siria,1,5,0,6
2015,Marzo,3,3/1/2015,Sri Lanka,0,7,0,7
2015,Marzo,3,3/1/2015,Sudáfrica,46,122,0,168
2015,Marzo,3,3/1/2015,Sudán,0,1,0,1
2015,Marzo,3,3/1/2015,Suecia,222,356,0,578
2015,Marzo,3,3/1/2015,Suiza,440,805,0,1245
2015,Marzo,3,3/1/2015,Surinam,18,30,0,48
2015,Marzo,3,3/1/2015,Taiwán,106,146,0,252
2015,Marzo,3,3/1/2015,Tailandia,30,14,0,44
2015,Marzo,3,3/1/2015,Tanzania,0,3,0,3
2015,Marzo,3,3/1/2015,Trinidad y Tobago,25,81,0,106
2015,Marzo,3,3/1/2015,Túnez,1,4,0,5
2015,Marzo,3,3/1/2015,Turquía,74,139,0,213
2015,Marzo,3,3/1/2015,Ucrania,46,75,0,121
2015,Marzo,3,3/1/2015,Uganda,1,1,0,2
2015,Marzo,3,3/1/2015,Uruguay,433,633,0,1066
2015,Marzo,3,3/1/2015,Uzbekistán,2,1,0,3
2015,Marzo,3,3/1/2015,Venezuela,11501,14165,0,25666
2015,Marzo,3,3/1/2015,Vietnam,5,1,0,6
2015,Marzo,3,3/1/2015,Islas Vírgenes Británicas/Territorio Británico de Ultramar,1,1,0,2
2015,Marzo,3,3/1/2015,República Árabe de Yemen,1,3,0,4
2015,Marzo,3,3/1/2015,Zambia,0,1,0,1
2015,Marzo,3,3/1/2015,Zimbabue,0,4,0,4
2015,Marzo,3,3/1/2015,Islas Turcas y Caicos/Territorio Británico de Ultramar,1,1,0,2
2015,Marzo,3,3/1/2015,Desconocido,50,119,0,169
2015,Abril,4,4/1/2015,Afganistán,0,10,0,10
2015,Abril,4,4/1/2015,Albania,0,1,0,1
2015,Abril,4,4/1/2015,Alemania,1564,2447,0,4011
2015,Abril,4,4/1/2015,Andorra,4,9,0,13
2015,Abril,4,4/1/2015,Angola,0,1,0,1
2015,Abril,4,4/1/2015,Antigua y Barbuda,2,12,0,14
2015,Abril,4,4/1/2015,Países Bajos,1358,2060,0,3418
2015,Abril,4,4/1/2015,Arabia Saudita,1,9,0,10
2015,Abril,4,4/1/2015,Argelia,1,2,0,3
2015,Abril,4,4/1/2015,Argentina,4988,6095,0,11083
2015,Abril,4,4/1/2015,República de Armenia,4,2,0,6
2015,Abril,4,4/1/2015,Aruba,1,1,0,2
2015,Abril,4,4/1/2015,Australia,350,605,0,955
2015,Abril,4,4/1/2015,Austria,106,283,0,389
2015,Abril,4,4/1/2015,Azerbaiyán,1,2,0,3
2015,Abril,4,4/1/2015,Bahamas,4,10,0,14
2015,Abril,4,4/1/2015,Bahréin,0,2,0,2
2015,Abril,4,4/1/2015,Bangladesh,1,3,0,4
2015,Abril,4,4/1/2015,Barbados,4,18,0,22
2015,Abril,4,4/1/2015,República de Belarús,5,3,0,8
2015,Abril,4,4/1/2015,Bélgica,166,383,0,549
2015,Abril,4,4/1/2015,Belice,3,17,0,20
2015,Abril,4,4/1/2015,Bermudas/Territorio Británico de Ultramar,0,1,0,1
2015,Abril,4,4/1/2015,Bolivia,397,564,0,961
2015,Abril,4,4/1/2015,Bosnia y Herzegovina,0,1,0,1
2015,Abril,4,4/1/2015,Brasil,5277,6107,0,11384
2015,Abril,4,4/1/2015,Brunei Darussalam,1,0,0,1
2015,Abril,4,4/1/2015,Bulgaria,28,42,0,70
2015,Abril,4,4/1/2015,Burkina Faso,0,1,0,1
2015,Abril,4,4/1/2015,Burundi,0,1,0,1
2015,Abril,4,4/1/2015,Islas Caimán/Territorio Británico de Ultramar,0,2,0,2
2015,Abril,4,4/1/2015,Camboya,0,2,0,2
2015,Abril,4,4/1/2015,Camerún,2,2,0,4
2015,Abril,4,4/1/2015,Canadá,968,1664,0,2632
2015,Abril,4,4/1/2015,España,2446,5910,0,8356
2015,Abril,4,4/1/2015,República Democrática del Congo,1,2,0,3
2015,Abril,4,4/1/2015,República de Corea,275,795,0,1070
2015,Abril,4,4/1/2015,Costa de Marfil,0,2,0,2
2015,Abril,4,4/1/2015,Costa Rica,941,1494,0,2435
2015,Abril,4,4/1/2015,Croacia,16,45,0,61
2015,Abril,4,4/1/2015,Cuba,330,480,0,810
2015,Abril,4,4/1/2015,República Checa,66,70,0,136
2015,Abril,4,4/1/2015,Chile,3667,4806,0,8473
2015,Abril,4,4/1/2015,China,266,794,0,1060
2015,Abril,4,4/1/2015,Chipre,5,2,0,7
2015,Abril,4,4/1/2015,Dinamarca,86,176,0,262
2015,Abril,4,4/1/2015,Dominica,0,3,0,3
2015,Abril,4,4/1/2015,Ecuador,5214,7085,0,12299
2015,Abril,4,4/1/2015,Egipto,5,20,0,25
2015,Abril,4,4/1/2015,El Salvador,770,1011,0,1781
2015,Abril,4,4/1/2015,Emiratos Árabes,1,0,0,1
2015,Abril,4,4/1/2015,Eritrea,0,2,0,2
2015,Abril,4,4/1/2015,Eslovaquia,24,25,0,49
2015,Abril,4,4/1/2015,Eslovenia,21,30,0,51
2015,Abril,4,4/1/2015,Estados Unidos de América,9950,18769,0,28719
2015,Abril,4,4/1/2015,Estonia,9,26,0,35
2015,Abril,4,4/1/2015,Etiopia,1,2,0,3
2015,Abril,4,4/1/2015,Filipinas,35,183,0,218
2015,Abril,4,4/1/2015,Finlandia,50,85,0,135
2015,Abril,4,4/1/2015,Francia,1433,2453,0,3886
2015,Abril,4,4/1/2015,Georgia,3,2,0,5
2015,Abril,4,4/1/2015,Ghana,0,3,0,3
2015,Abril,4,4/1/2015,Granada,3,5,0,8
2015,Abril,4,4/1/2015,Grecia,26,81,0,107
2015,Abril,4,4/1/2015,Guatemala,365,839,0,1204
2015,Abril,4,4/1/2015,Guyana,7,15,0,22
2015,Abril,4,4/1/2015,Guinea,1,0,0,1
2015,Abril,4,4/1/2015,Haití,3,19,0,22
2015,Abril,4,4/1/2015,Honduras,231,367,0,598
2015,Abril,4,4/1/2015,Hong Kong,3,0,0,3
2015,Abril,4,4/1/2015,Hungría,15,32,0,47
2015,Abril,4,4/1/2015,India,54,408,0,462
2015,Abril,4,4/1/2015,Indonesia,12,24,0,36
2015,Abril,4,4/1/2015,Iraq,0,1,0,1
2015,Abril,4,4/1/2015,Irán,3,22,0,25
2015,Abril,4,4/1/2015,República de Irlanda,103,221,0,324
2015,Abril,4,4/1/2015,Islandia,4,13,0,17
2015,Abril,4,4/1/2015,Israel,318,1157,0,1475
2015,Abril,4,4/1/2015,Italia,626,1956,0,2582
2015,Abril,4,4/1/2015,Jamaica,9,25,0,34
2015,Abril,4,4/1/2015,Japón,144,476,0,620
2015,Abril,4,4/1/2015,Jordania,2,5,0,7
2015,Abril,4,4/1/2015,Kazajistán,4,0,0,4
2015,Abril,4,4/1/2015,Kenia,12,32,0,44
2015,Abril,4,4/1/2015,Kiribati,0,3,0,3
2015,Abril,4,4/1/2015,Kuwait,0,9,0,9
2015,Abril,4,4/1/2015,Letonia,11,7,0,18
2015,Abril,4,4/1/2015,Lituania,15,21,0,36
2015,Abril,4,4/1/2015,Líbano,12,23,0,35
2015,Abril,4,4/1/2015,Liechtenstein,3,3,0,6
2015,Abril,4,4/1/2015,Luxemburgo,6,12,0,18
2015,Abril,4,4/1/2015,Macedonia,1,1,0,2
2015,Abril,4,4/1/2015,Madagascar,4,0,0,4
2015,Abril,4,4/1/2015,Malasia,18,39,0,57
2015,Abril,4,4/1/2015,Malawi,0,1,0,1
2015,Abril,4,4/1/2015,Malí,0,1,0,1
2015,Abril,4,4/1/2015,Malta,2,12,0,14
2015,Abril,4,4/1/2015,Marruecos,7,13,0,20
2015,Abril,4,4/1/2015,Mauricio,0,3,0,3
2015,Abril,4,4/1/2015,México,4231,8055,0,12286
2015,Abril,4,4/1/2015,República de Moldavia,3,1,0,4
2015,Abril,4,4/1/2015,Mongolia,1,0,0,1
2015,Abril,4,4/1/2015,Montenegro,2,2,0,4
2015,Abril,4,4/1/2015,Mozambique,1,2,0,3
2015,Abril,4,4/1/2015,Myanmar,1,3,0,4
2015,Abril,4,4/1/2015,Namibia,0,1,0,1
2015,Abril,4,4/1/2015,Nepal,1,2,0,3
2015,Abril,4,4/1/2015,Nicaragua,80,128,0,208
2015,Abril,4,4/1/2015,Nigeria,0,7,0,7
2015,Abril,4,4/1/2015,Noruega,99,142,0,241
2015,Abril,4,4/1/2015,Nueva Zelanda,61,112,0,173
2015,Abril,4,4/1/2015,Pakistán,1,17,0,18
2015,Abril,4,4/1/2015,Panamá,1798,2366,0,4164
2015,Abril,4,4/1/2015,Paraguay,324,253,0,577
2015,Abril,4,4/1/2015,Perú,4712,5891,0,10603
2015,Abril,4,4/1/2015,Palestina,0,3,0,3
2015,Abril,4,4/1/2015,Polonia,132,188,0,320
2015,Abril,4,4/1/2015,Portugal,308,664,0,972
2015,Abril,4,4/1/2015,Qatar,0,2,0,2
2015,Abril,4,4/1/2015,Reino Unido de Gran Bretaña e Irlanda del Norte,985,1941,0,2926
2015,Abril,4,4/1/2015,Federación de Rusia,158,218,0,376
2015,Abril,4,4/1/2015,República Dominicana,419,579,0,998
2015,Abril,4,4/1/2015,Rumania,61,94,0,155
2015,Abril,4,4/1/2015,Rwanda,0,2,0,2
2015,Abril,4,4/1/2015,San Cristóbal y Nevis,1,1,0,2
2015,Abril,4,4/1/2015,San Marino,0,1,0,1
2015,Abril,4,4/1/2015,San  Vicente y las Granadinas,0,2,0,2
2015,Abril,4,4/1/2015,Santa Lucia,4,9,0,13
2015,Abril,4,4/1/2015,Santa Sede/Ciudad del Vaticano,0,1,0,1
2015,Abril,4,4/1/2015,Senegal,1,3,0,4
2015,Abril,4,4/1/2015,Serbia,6,6,0,12
2015,Abril,4,4/1/2015,Singapur,13,17,0,30
2015,Abril,4,4/1/2015,República Árabe Siria,1,1,0,2
2015,Abril,4,4/1/2015,Sri Lanka,2,5,0,7
2015,Abril,4,4/1/2015,Sudáfrica,35,91,0,126
2015,Abril,4,4/1/2015,Sudán,0,1,0,1
2015,Abril,4,4/1/2015,Suecia,190,287,0,477
2015,Abril,4,4/1/2015,Suiza,423,714,0,1137
2015,Abril,4,4/1/2015,Surinam,10,20,0,30
2015,Abril,4,4/1/2015,Taiwán,55,84,0,139
2015,Abril,4,4/1/2015,Tailandia,10,9,0,19
2015,Abril,4,4/1/2015,Tanzania,0,2,0,2
2015,Abril,4,4/1/2015,Togo,0,1,0,1
2015,Abril,4,4/1/2015,Trinidad y Tobago,33,91,0,124
2015,Abril,4,4/1/2015,Túnez,3,5,0,8
2015,Abril,4,4/1/2015,Turquía,35,129,0,164
2015,Abril,4,4/1/2015,Ucrania,32,42,0,74
2015,Abril,4,4/1/2015,Uganda,3,2,0,5
2015,Abril,4,4/1/2015,Uruguay,329,525,0,854
2015,Abril,4,4/1/2015,Uzbekistán,2,0,0,2
2015,Abril,4,4/1/2015,Venezuela,11142,14216,0,25358
2015,Abril,4,4/1/2015,Vietnam,1,2,0,3
2015,Abril,4,4/1/2015,República Árabe de Yemen,2,1,0,3
2015,Abril,4,4/1/2015,Zambia,0,2,0,2
2015,Abril,4,4/1/2015,Zimbabue,1,2,0,3
2015,Abril,4,4/1/2015,Islas Turcas y Caicos/Territorio Británico de Ultramar,0,2,0,2
2015,Abril,4,4/1/2015,Desconocido,78,135,0,213
2015,Mayo,5,5/1/2015,Afganistán,0,1,0,1
2015,Mayo,5,5/1/2015,Albania,0,4,0,4
2015,Mayo,5,5/1/2015,Alemania,1455,2342,0,3797
2015,Mayo,5,5/1/2015,Andorra,1,7,0,8
2015,Mayo,5,5/1/2015,Angola,1,4,0,5
2015,Mayo,5,5/1/2015,Antigua y Barbuda,3,9,0,12
2015,Mayo,5,5/1/2015,Países Bajos,1238,1922,0,3160
2015,Mayo,5,5/1/2015,Arabia Saudita,1,15,0,16
2015,Mayo,5,5/1/2015,Argelia,1,9,0,10
2015,Mayo,5,5/1/2015,Argentina,4773,6021,0,10794
2015,Mayo,5,5/1/2015,República de Armenia,1,4,0,5
2015,Mayo,5,5/1/2015,Aruba,1,4,0,5
2015,Mayo,5,5/1/2015,Australia,394,734,0,1128
2015,Mayo,5,5/1/2015,Austria,132,250,0,382
2015,Mayo,5,5/1/2015,Azerbaiyán,3,3,0,6
2015,Mayo,5,5/1/2015,Bahamas,4,8,0,12
2015,Mayo,5,5/1/2015,Bahréin,0,1,0,1
2015,Mayo,5,5/1/2015,Bangladesh,0,6,0,6
2015,Mayo,5,5/1/2015,Barbados,2,8,0,10
2015,Mayo,5,5/1/2015,República de Belarús,3,7,0,10
2015,Mayo,5,5/1/2015,Bélgica,144,385,0,529
2015,Mayo,5,5/1/2015,Belice,3,20,0,23
2015,Mayo,5,5/1/2015,Bermudas/Territorio Británico de Ultramar,1,5,0,6
2015,Mayo,5,5/1/2015,Bolivia,482,576,0,1058
2015,Mayo,5,5/1/2015,Bosnia y Herzegovina,0,1,0,1
2015,Mayo,5,5/1/2015,Brasil,4735,6318,0,11053
2015,Mayo,5,5/1/2015,Brunei Darussalam,1,0,0,1
2015,Mayo,5,5/1/2015,Bulgaria,17,34,0,51
2015,Mayo,5,5/1/2015,Burkina Faso,1,0,0,1
2015,Mayo,5,5/1/2015,Burundi,1,0,0,1
2015,Mayo,5,5/1/2015,Bután,0,1,0,1
2015,Mayo,5,5/1/2015,Islas Caimán/Territorio Británico de Ultramar,3,5,0,8
2015,Mayo,5,5/1/2015,Camboya,1,2,0,3
2015,Mayo,5,5/1/2015,Camerún,1,2,0,3
2015,Mayo,5,5/1/2015,Canadá,902,1598,0,2500
2015,Mayo,5,5/1/2015,España,2505,6183,0,8688
2015,Mayo,5,5/1/2015,República de Corea,215,500,0,715
2015,Mayo,5,5/1/2015,Costa de Marfil,0,1,0,1
2015,Mayo,5,5/1/2015,Costa Rica,970,1518,0,2488
2015,Mayo,5,5/1/2015,Croacia,7,45,0,52
2015,Mayo,5,5/1/2015,Cuba,351,577,0,928
2015,Mayo,5,5/1/2015,República Checa,41,61,0,102
2015,Mayo,5,5/1/2015,Chile,4573,5682,0,10255
2015,Mayo,5,5/1/2015,China,441,1138,0,1579
2015,Mayo,5,5/1/2015,Chipre,1,7,0,8
2015,Mayo,5,5/1/2015,Dinamarca,111,194,0,305
2015,Mayo,5,5/1/2015,Dominica,3,5,0,8
2015,Mayo,5,5/1/2015,Ecuador,4163,6922,0,11085
2015,Mayo,5,5/1/2015,Egipto,7,30,0,37
2015,Mayo,5,5/1/2015,El Salvador,748,1007,0,1755
2015,Mayo,5,5/1/2015,Emiratos Árabes,0,10,0,10
2015,Mayo,5,5/1/2015,Eritrea,0,1,0,1
2015,Mayo,5,5/1/2015,Eslovaquia,18,16,0,34
2015,Mayo,5,5/1/2015,Eslovenia,8,17,0,25
2015,Mayo,5,5/1/2015,Estados Unidos de América,11596,21176,0,32772
2015,Mayo,5,5/1/2015,Estonia,6,10,0,16
2015,Mayo,5,5/1/2015,Etiopia,3,0,0,3
2015,Mayo,5,5/1/2015,Filipinas,35,228,0,263
2015,Mayo,5,5/1/2015,Finlandia,49,98,0,147
2015,Mayo,5,5/1/2015,Francia,1248,2311,0,3559
2015,Mayo,5,5/1/2015,Georgia,1,6,0,7
2015,Mayo,5,5/1/2015,Ghana,1,9,0,10
2015,Mayo,5,5/1/2015,Granada,3,5,0,8
2015,Mayo,5,5/1/2015,Grecia,17,69,0,86
2015,Mayo,5,5/1/2015,Guatemala,441,949,0,1390
2015,Mayo,5,5/1/2015,Guyana,8,14,0,22
2015,Mayo,5,5/1/2015,Guinea,0,1,0,1
2015,Mayo,5,5/1/2015,Guinea Bissau,0,1,0,1
2015,Mayo,5,5/1/2015,Haití,5,15,0,20
2015,Mayo,5,5/1/2015,Honduras,238,342,0,580
2015,Mayo,5,5/1/2015,Hong Kong,3,2,0,5
2015,Mayo,5,5/1/2015,Hungría,18,44,0,62
2015,Mayo,5,5/1/2015,India,70,503,0,573
2015,Mayo,5,5/1/2015,Indonesia,7,39,0,46
2015,Mayo,5,5/1/2015,Irán,4,19,0,23
2015,Mayo,5,5/1/2015,República de Irlanda,107,200,0,307
2015,Mayo,5,5/1/2015,Islandia,8,5,0,13
2015,Mayo,5,5/1/2015,Israel,345,1015,0,1360
2015,Mayo,5,5/1/2015,Italia,574,2011,0,2585
2015,Mayo,5,5/1/2015,Jamaica,23,39,0,62
2015,Mayo,5,5/1/2015,Japón,147,568,0,715
2015,Mayo,5,5/1/2015,Jordania,2,4,0,6
2015,Mayo,5,5/1/2015,Kazajistán,10,4,0,14
2015,Mayo,5,5/1/2015,Kenia,3,8,0,11
2015,Mayo,5,5/1/2015,Kiribati,0,4,0,4
2015,Mayo,5,5/1/2015,Kirguistán,0,1,0,1
2015,Mayo,5,5/1/2015,Kuwait,1,5,0,6
2015,Mayo,5,5/1/2015,República de Kosovo,0,3,0,3
2015,Mayo,5,5/1/2015,Letonia,5,13,0,18
2015,Mayo,5,5/1/2015,Lituania,19,17,0,36
2015,Mayo,5,5/1/2015,Líbano,20,28,0,48
2015,Mayo,5,5/1/2015,Liechtenstein,2,1,0,3
2015,Mayo,5,5/1/2015,Luxemburgo,4,8,0,12
2015,Mayo,5,5/1/2015,Macedonia,0,3,0,3
2015,Mayo,5,5/1/2015,Madagascar,1,0,0,1
2015,Mayo,5,5/1/2015,Malasia,8,23,0,31
2015,Mayo,5,5/1/2015,Malta,0,5,0,5
2015,Mayo,5,5/1/2015,Marruecos,8,9,0,17
2015,Mayo,5,5/1/2015,Mauricio,0,1,0,1
2015,Mayo,5,5/1/2015,México,4368,7988,0,12356
2015,Mayo,5,5/1/2015,República de Moldavia,2,0,0,2
2015,Mayo,5,5/1/2015,Mónaco,1,0,0,1
2015,Mayo,5,5/1/2015,Mongolia,3,2,0,5
2015,Mayo,5,5/1/2015,Montenegro,1,3,0,4
2015,Mayo,5,5/1/2015,Mozambique,1,1,0,2
2015,Mayo,5,5/1/2015,Myanmar,1,0,0,1
2015,Mayo,5,5/1/2015,Nepal,1,3,0,4
2015,Mayo,5,5/1/2015,Nicaragua,91,140,0,231
2015,Mayo,5,5/1/2015,Nigeria,1,14,0,15
2015,Mayo,5,5/1/2015,Noruega,69,115,0,184
2015,Mayo,5,5/1/2015,Nueva Zelanda,64,128,0,192
2015,Mayo,5,5/1/2015,Pakistán,2,14,0,16
2015,Mayo,5,5/1/2015,Panamá,1930,2533,0,4463
2015,Mayo,5,5/1/2015,Paraguay,420,431,0,851
2015,Mayo,5,5/1/2015,Perú,5299,6066,0,11365
2015,Mayo,5,5/1/2015,Palestina,1,5,0,6
2015,Mayo,5,5/1/2015,Polonia,159,213,0,372
2015,Mayo,5,5/1/2015,Portugal,231,611,0,842
2015,Mayo,5,5/1/2015,Qatar,0,3,0,3
2015,Mayo,5,5/1/2015,Reino Unido de Gran Bretaña e Irlanda del Norte,984,2257,0,3241
2015,Mayo,5,5/1/2015,Federación de Rusia,179,244,0,423
2015,Mayo,5,5/1/2015,República Dominicana,473,653,0,1126
2015,Mayo,5,5/1/2015,República Democrática Popular de Corea,1,1,0,2
2015,Mayo,5,5/1/2015,Rumania,57,75,0,132
2015,Mayo,5,5/1/2015,Rwanda,0,2,0,2
2015,Mayo,5,5/1/2015,San Cristóbal y Nevis,2,2,0,4
2015,Mayo,5,5/1/2015,San Marino,1,2,0,3
2015,Mayo,5,5/1/2015,San  Vicente y las Granadinas,0,4,0,4
2015,Mayo,5,5/1/2015,Santa Lucia,4,4,0,8
2015,Mayo,5,5/1/2015,Santa Sede/Ciudad del Vaticano,0,2,0,2
2015,Mayo,5,5/1/2015,Senegal,0,2,0,2
2015,Mayo,5,5/1/2015,Serbia,5,13,0,18
2015,Mayo,5,5/1/2015,Singapur,12,24,0,36
2015,Mayo,5,5/1/2015,República Árabe Siria,0,5,0,5
2015,Mayo,5,5/1/2015,Sri Lanka,0,5,0,5
2015,Mayo,5,5/1/2015,Sudáfrica,58,103,0,161
2015,Mayo,5,5/1/2015,Sudán,0,2,0,2
2015,Mayo,5,5/1/2015,Suecia,162,258,0,420
2015,Mayo,5,5/1/2015,Suiza,349,627,0,976
2015,Mayo,5,5/1/2015,Surinam,22,30,0,52
2015,Mayo,5,5/1/2015,Suazilandia,0,1,0,1
2015,Mayo,5,5/1/2015,Taiwán,67,98,0,165
2015,Mayo,5,5/1/2015,República de Tayikistán,1,3,0,4
2015,Mayo,5,5/1/2015,Tailandia,7,6,0,13
2015,Mayo,5,5/1/2015,Tanzania,1,0,0,1
2015,Mayo,5,5/1/2015,Trinidad y Tobago,47,73,0,120
2015,Mayo,5,5/1/2015,Túnez,0,5,0,5
2015,Mayo,5,5/1/2015,Turquía,20,112,0,132
2015,Mayo,5,5/1/2015,Ucrania,20,46,0,66
2015,Mayo,5,5/1/2015,Uganda,1,5,0,6
2015,Mayo,5,5/1/2015,Uruguay,385,633,0,1018
2015,Mayo,5,5/1/2015,Uzbekistán,3,0,0,3
2015,Mayo,5,5/1/2015,Venezuela,10836,14379,0,25215
2015,Mayo,5,5/1/2015,Vietnam,11,13,0,24
2015,Mayo,5,5/1/2015,Zambia,6,4,0,10
2015,Mayo,5,5/1/2015,Zimbabue,5,4,0,9
2015,Mayo,5,5/1/2015,Desconocido,64,135,0,199
2015,Junio,6,6/1/2015,Afganistán,3,5,0,8
2015,Junio,6,6/1/2015,Albania,2,8,0,10
2015,Junio,6,6/1/2015,Alemania,1413,2328,0,3741
2015,Junio,6,6/1/2015,Andorra,1,10,0,11
2015,Junio,6,6/1/2015,Angola,0,1,0,1
2015,Junio,6,6/1/2015,Antigua y Barbuda,4,11,0,15
2015,Junio,6,6/1/2015,Países Bajos,1039,1738,0,2777
2015,Junio,6,6/1/2015,Arabia Saudita,1,8,0,9
2015,Junio,6,6/1/2015,Argelia,2,8,0,10
2015,Junio,6,6/1/2015,Argentina,3537,5205,0,8742
2015,Junio,6,6/1/2015,República de Armenia,0,3,0,3
2015,Junio,6,6/1/2015,Australia,401,614,0,1015
2015,Junio,6,6/1/2015,Austria,125,219,0,344
2015,Junio,6,6/1/2015,Azerbaiyán,2,6,0,8
2015,Junio,6,6/1/2015,Bahamas,15,22,0,37
2015,Junio,6,6/1/2015,Bahréin,1,4,0,5
2015,Junio,6,6/1/2015,Bangladesh,0,2,0,2
2015,Junio,6,6/1/2015,Barbados,3,18,0,21
2015,Junio,6,6/1/2015,República de Belarús,5,3,0,8
2015,Junio,6,6/1/2015,Bélgica,249,465,0,714
2015,Junio,6,6/1/2015,Belice,10,10,0,20
2015,Junio,6,6/1/2015,Benín,1,3,0,4
2015,Junio,6,6/1/2015,Bermudas/Territorio Británico de Ultramar,1,0,0,1
2015,Junio,6,6/1/2015,Bolivia,638,691,0,1329
2015,Junio,6,6/1/2015,Bosnia y Herzegovina,0,3,0,3
2015,Junio,6,6/1/2015,Botsuana,2,1,0,3
2015,Junio,6,6/1/2015,Brasil,3975,5448,0,9423
2015,Junio,6,6/1/2015,Brunei Darussalam,0,2,0,2
2015,Junio,6,6/1/2015,Bulgaria,27,25,0,52
2015,Junio,6,6/1/2015,Cabo Verde,0,1,0,1
2015,Junio,6,6/1/2015,Islas Caimán/Territorio Británico de Ultramar,0,1,0,1
2015,Junio,6,6/1/2015,Camerún,2,5,0,7
2015,Junio,6,6/1/2015,Canadá,1067,1752,0,2819
2015,Junio,6,6/1/2015,España,2883,6580,0,9463
2015,Junio,6,6/1/2015,República Democrática del Congo,1,1,0,2
2015,Junio,6,6/1/2015,República de Corea,213,462,0,675
2015,Junio,6,6/1/2015,Costa de Marfil,1,2,0,3
2015,Junio,6,6/1/2015,Costa Rica,863,1316,0,2179
2015,Junio,6,6/1/2015,Croacia,12,50,0,62
2015,Junio,6,6/1/2015,Cuba,504,702,0,1206
2015,Junio,6,6/1/2015,República Checa,61,64,0,125
2015,Junio,6,6/1/2015,Chile,2792,4144,0,6936
2015,Junio,6,6/1/2015,China,320,758,0,1078
2015,Junio,6,6/1/2015,Chipre,5,7,0,12
2015,Junio,6,6/1/2015,Dinamarca,107,196,0,303
2015,Junio,6,6/1/2015,Dominica,0,3,0,3
2015,Junio,6,6/1/2015,Ecuador,3861,6100,0,9961
2015,Junio,6,6/1/2015,Egipto,6,22,0,28
2015,Junio,6,6/1/2015,El Salvador,683,999,0,1682
2015,Junio,6,6/1/2015,Emiratos Árabes,2,5,0,7
2015,Junio,6,6/1/2015,Eritrea,0,3,0,3
2015,Junio,6,6/1/2015,Eslovaquia,32,23,0,55
2015,Junio,6,6/1/2015,Eslovenia,8,26,0,34
2015,Junio,6,6/1/2015,Estados Unidos de América,18623,27104,0,45727
2015,Junio,6,6/1/2015,Estonia,13,18,0,31
2015,Junio,6,6/1/2015,Etiopia,2,5,0,7
2015,Junio,6,6/1/2015,Islas Fiji,1,0,0,1
2015,Junio,6,6/1/2015,Filipinas,42,239,0,281
2015,Junio,6,6/1/2015,Finlandia,63,78,0,141
2015,Junio,6,6/1/2015,Francia,1483,2612,0,4095
2015,Junio,6,6/1/2015,Gabón,0,1,0,1
2015,Junio,6,6/1/2015,Georgia,8,10,0,18
2015,Junio,6,6/1/2015,Ghana,2,7,0,9
2015,Junio,6,6/1/2015,Granada,1,4,0,5
2015,Junio,6,6/1/2015,Grecia,20,72,0,92
2015,Junio,6,6/1/2015,Guatemala,532,987,0,1519
2015,Junio,6,6/1/2015,Guyana,8,14,0,22
2015,Junio,6,6/1/2015,Guinea,0,2,0,2
2015,Junio,6,6/1/2015,Haití,10,30,0,40
2015,Junio,6,6/1/2015,Honduras,220,345,0,565
2015,Junio,6,6/1/2015,Hong Kong,2,3,0,5
2015,Junio,6,6/1/2015,Hungría,23,31,0,54
2015,Junio,6,6/1/2015,India,76,431,0,507
2015,Junio,6,6/1/2015,Indonesia,22,41,0,63
2015,Junio,6,6/1/2015,Irán,4,15,0,19
2015,Junio,6,6/1/2015,República de Irlanda,155,232,0,387
2015,Junio,6,6/1/2015,Islandia,6,7,0,13
2015,Junio,6,6/1/2015,Israel,259,840,0,1099
2015,Junio,6,6/1/2015,Italia,719,2003,0,2722
2015,Junio,6,6/1/2015,Jamaica,45,82,0,127
2015,Junio,6,6/1/2015,Japón,160,528,0,688
2015,Junio,6,6/1/2015,Jordania,0,3,0,3
2015,Junio,6,6/1/2015,Kazajistán,6,5,0,11
2015,Junio,6,6/1/2015,Kenia,17,23,0,40
2015,Junio,6,6/1/2015,Kuwait,0,6,0,6
2015,Junio,6,6/1/2015,Lesoto,2,0,0,2
2015,Junio,6,6/1/2015,Letonia,7,32,0,39
2015,Junio,6,6/1/2015,Lituania,22,24,0,46
2015,Junio,6,6/1/2015,Líbano,29,36,0,65
2015,Junio,6,6/1/2015,Libia,0,1,0,1
2015,Junio,6,6/1/2015,Liechtenstein,2,2,0,4
2015,Junio,6,6/1/2015,Luxemburgo,2,2,0,4
2015,Junio,6,6/1/2015,Macedonia,0,2,0,2
2015,Junio,6,6/1/2015,Malasia,16,27,0,43
2015,Junio,6,6/1/2015,Malawi,0,1,0,1
2015,Junio,6,6/1/2015,Malí,0,1,0,1
2015,Junio,6,6/1/2015,Malta,1,7,0,8
2015,Junio,6,6/1/2015,Marruecos,14,8,0,22
2015,Junio,6,6/1/2015,Mauricio,4,3,0,7
2015,Junio,6,6/1/2015,Mauritania,1,0,0,1
2015,Junio,6,6/1/2015,México,4718,8483,0,13201
2015,Junio,6,6/1/2015,República de Moldavia,4,1,0,5
2015,Junio,6,6/1/2015,Mónaco,0,1,0,1
2015,Junio,6,6/1/2015,Mongolia,2,2,0,4
2015,Junio,6,6/1/2015,Montenegro,0,2,0,2
2015,Junio,6,6/1/2015,Mozambique,0,1,0,1
2015,Junio,6,6/1/2015,Myanmar,0,3,0,3
2015,Junio,6,6/1/2015,Nepal,1,9,0,10
2015,Junio,6,6/1/2015,Nicaragua,92,104,0,196
2015,Junio,6,6/1/2015,Nigeria,2,9,0,11
2015,Junio,6,6/1/2015,Noruega,153,257,0,410
2015,Junio,6,6/1/2015,Nueva Zelanda,80,135,0,215
2015,Junio,6,6/1/2015,Omán,0,2,0,2
2015,Junio,6,6/1/2015,Pakistán,0,17,0,17
2015,Junio,6,6/1/2015,Panamá,1706,2304,0,4010
2015,Junio,6,6/1/2015,Paraguay,437,345,0,782
2015,Junio,6,6/1/2015,Perú,4064,5242,0,9306
2015,Junio,6,6/1/2015,Palestina,2,3,0,5
2015,Junio,6,6/1/2015,Polonia,101,149,0,250
2015,Junio,6,6/1/2015,Portugal,240,557,0,797
2015,Junio,6,6/1/2015,Qatar,0,3,0,3
2015,Junio,6,6/1/2015,Reino Unido de Gran Bretaña e Irlanda del Norte,1105,2183,0,3288
2015,Junio,6,6/1/2015,República CentroÁfricana,0,1,0,1
2015,Junio,6,6/1/2015,Federación de Rusia,149,202,0,351
2015,Junio,6,6/1/2015,República Dominicana,474,739,0,1213
2015,Junio,6,6/1/2015,Rumania,44,96,0,140
2015,Junio,6,6/1/2015,Rwanda,0,1,0,1
2015,Junio,6,6/1/2015,San Cristóbal y Nevis,1,5,0,6
2015,Junio,6,6/1/2015,Samoa Occidental,1,0,0,1
2015,Junio,6,6/1/2015,San  Vicente y las Granadinas,2,4,0,6
2015,Junio,6,6/1/2015,Santa Lucia,5,2,0,7
2015,Junio,6,6/1/2015,Santa Sede/Ciudad del Vaticano,0,1,0,1
2015,Junio,6,6/1/2015,Senegal,4,7,0,11
2015,Junio,6,6/1/2015,Serbia,7,15,0,22
2015,Junio,6,6/1/2015,Seychelles,0,2,0,2
2015,Junio,6,6/1/2015,Sierra Leona,0,1,0,1
2015,Junio,6,6/1/2015,Singapur,26,35,0,61
2015,Junio,6,6/1/2015,República Árabe Siria,1,4,0,5
2015,Junio,6,6/1/2015,Sri Lanka,1,3,0,4
2015,Junio,6,6/1/2015,Sudáfrica,48,107,0,155
2015,Junio,6,6/1/2015,Sudán,0,2,0,2
2015,Junio,6,6/1/2015,Suecia,223,344,0,567
2015,Junio,6,6/1/2015,Suiza,406,682,0,1088
2015,Junio,6,6/1/2015,Surinam,23,19,0,42
2015,Junio,6,6/1/2015,Taiwán,67,95,0,162
2015,Junio,6,6/1/2015,Tailandia,32,24,0,56
2015,Junio,6,6/1/2015,Tanzania,5,5,0,10
2015,Junio,6,6/1/2015,Togo,0,2,0,2
2015,Junio,6,6/1/2015,Trinidad y Tobago,33,99,0,132
2015,Junio,6,6/1/2015,Túnez,1,6,0,7
2015,Junio,6,6/1/2015,Turquía,29,101,0,130
2015,Junio,6,6/1/2015,Ucrania,20,34,0,54
2015,Junio,6,6/1/2015,Uganda,6,4,0,10
2015,Junio,6,6/1/2015,Uruguay,412,578,0,990
2015,Junio,6,6/1/2015,Uzbekistán,1,0,0,1
2015,Junio,6,6/1/2015,Venezuela,10547,13504,0,24051
2015,Junio,6,6/1/2015,Vietnam,4,13,0,17
2015,Junio,6,6/1/2015,República Árabe de Yemen,0,1,0,1
2015,Junio,6,6/1/2015,Zambia,2,3,0,5
2015,Junio,6,6/1/2015,Zimbabue,1,1,0,2
2015,Junio,6,6/1/2015,Desconocido,53,137,0,190
2015,Julio,7,7/1/2015,Afganistán,0,1,0,1
2015,Julio,7,7/1/2015,Albania,2,6,0,8
2015,Julio,7,7/1/2015,Alemania,2297,2958,0,5255
2015,Julio,7,7/1/2015,Andorra,0,9,0,9
2015,Julio,7,7/1/2015,Angola,1,4,0,5
2015,Julio,7,7/1/2015,Antigua y Barbuda,3,16,0,19
2015,Julio,7,7/1/2015,Países Bajos,2254,2920,0,5174
2015,Julio,7,7/1/2015,Arabia Saudita,2,18,0,20
2015,Julio,7,7/1/2015,Argelia,1,20,0,21
2015,Julio,7,7/1/2015,Argentina,4579,5777,0,10356
2015,Julio,7,7/1/2015,República de Armenia,1,2,0,3
2015,Julio,7,7/1/2015,Aruba,1,4,0,5
2015,Julio,7,7/1/2015,Australia,475,785,0,1260
2015,Julio,7,7/1/2015,Austria,299,377,0,676
2015,Julio,7,7/1/2015,Azerbaiyán,2,6,0,8
2015,Julio,7,7/1/2015,Bahamas,19,25,0,44
2015,Julio,7,7/1/2015,Bahréin,6,7,0,13
2015,Julio,7,7/1/2015,Bangladesh,0,1,0,1
2015,Julio,7,7/1/2015,Barbados,21,26,0,47
2015,Julio,7,7/1/2015,República de Belarús,4,12,0,16
2015,Julio,7,7/1/2015,Bélgica,497,683,0,1180
2015,Julio,7,7/1/2015,Belice,11,18,0,29
2015,Julio,7,7/1/2015,Benín,0,2,0,2
2015,Julio,7,7/1/2015,Bermudas/Territorio Británico de Ultramar,3,7,0,10
2015,Julio,7,7/1/2015,Bolivia,661,711,0,1372
2015,Julio,7,7/1/2015,Bosnia y Herzegovina,2,2,0,4
2015,Julio,7,7/1/2015,Botsuana,1,5,0,6
2015,Julio,7,7/1/2015,Brasil,5191,6239,0,11430
2015,Julio,7,7/1/2015,Bulgaria,20,31,0,51
2015,Julio,7,7/1/2015,Burkina Faso,1,1,0,2
2015,Julio,7,7/1/2015,Islas Caimán/Territorio Británico de Ultramar,9,9,0,18
2015,Julio,7,7/1/2015,Camboya,1,0,0,1
2015,Julio,7,7/1/2015,Camerún,2,3,0,5
2015,Julio,7,7/1/2015,Canadá,1361,2013,0,3374
2015,Julio,7,7/1/2015,Chad,0,2,0,2
2015,Julio,7,7/1/2015,España,3519,7033,0,10552
2015,Julio,7,7/1/2015,Comoras,0,1,0,1
2015,Julio,7,7/1/2015,República Democrática del Congo,0,5,0,5
2015,Julio,7,7/1/2015,República de Corea,304,550,0,854
2015,Julio,7,7/1/2015,Costa de Marfil,1,3,0,4
2015,Julio,7,7/1/2015,Costa Rica,1217,1678,0,2895
2015,Julio,7,7/1/2015,Croacia,7,52,0,59
2015,Julio,7,7/1/2015,Cuba,258,421,0,679
2015,Julio,7,7/1/2015,República Checa,47,92,0,139
2015,Julio,7,7/1/2015,Chile,4313,5159,0,9472
2015,Julio,7,7/1/2015,China,430,903,0,1333
2015,Julio,7,7/1/2015,Chipre,3,10,0,13
2015,Julio,7,7/1/2015,Dinamarca,191,279,0,470
2015,Julio,7,7/1/2015,Dominica,4,6,0,10
2015,Julio,7,7/1/2015,Ecuador,5836,7674,0,13510
2015,Julio,7,7/1/2015,Egipto,17,37,0,54
2015,Julio,7,7/1/2015,El Salvador,815,1026,0,1841
2015,Julio,7,7/1/2015,Emiratos Árabes,7,22,0,29
2015,Julio,7,7/1/2015,Eslovaquia,33,30,0,63
2015,Julio,7,7/1/2015,Eslovenia,23,37,0,60
2015,Julio,7,7/1/2015,Estados Unidos de América,19243,28278,0,47521
2015,Julio,7,7/1/2015,Estonia,9,18,0,27
2015,Julio,7,7/1/2015,Etiopia,15,18,0,33
2015,Julio,7,7/1/2015,Islas Fiji,0,1,0,1
2015,Julio,7,7/1/2015,Filipinas,40,199,0,239
2015,Julio,7,7/1/2015,Finlandia,74,59,0,133
2015,Julio,7,7/1/2015,Francia,2681,3863,0,6544
2015,Julio,7,7/1/2015,Gabón,0,1,0,1
2015,Julio,7,7/1/2015,Georgia,4,7,0,11
2015,Julio,7,7/1/2015,Ghana,3,20,0,23
2015,Julio,7,7/1/2015,Granada,2,6,0,8
2015,Julio,7,7/1/2015,Grecia,56,92,0,148
2015,Julio,7,7/1/2015,Guatemala,539,1097,0,1636
2015,Julio,7,7/1/2015,Guyana,6,18,0,24
2015,Julio,7,7/1/2015,Guinea Ecuatorial,1,1,0,2
2015,Julio,7,7/1/2015,Guinea Bissau,0,2,0,2
2015,Julio,7,7/1/2015,Haití,9,26,0,35
2015,Julio,7,7/1/2015,Honduras,292,428,0,720
2015,Julio,7,7/1/2015,Hong Kong,5,2,0,7
2015,Julio,7,7/1/2015,Hungría,43,63,0,106
2015,Julio,7,7/1/2015,India,82,449,0,531
2015,Julio,7,7/1/2015,Indonesia,21,36,0,57
2015,Julio,7,7/1/2015,Iraq,1,8,0,9
2015,Julio,7,7/1/2015,Irán,9,18,0,27
2015,Julio,7,7/1/2015,República de Irlanda,196,285,0,481
2015,Julio,7,7/1/2015,Islandia,6,6,0,12
2015,Julio,7,7/1/2015,Israel,216,799,0,1015
2015,Julio,7,7/1/2015,Italia,935,2319,0,3254
2015,Julio,7,7/1/2015,Jamaica,54,74,0,128
2015,Julio,7,7/1/2015,Japón,183,608,0,791
2015,Julio,7,7/1/2015,Jordania,3,2,0,5
2015,Julio,7,7/1/2015,Kazajistán,12,2,0,14
2015,Julio,7,7/1/2015,Kenia,21,47,0,68
2015,Julio,7,7/1/2015,Kiribati,0,1,0,1
2015,Julio,7,7/1/2015,Kirguistán,2,0,0,2
2015,Julio,7,7/1/2015,Kuwait,1,3,0,4
2015,Julio,7,7/1/2015,República de Kosovo,0,1,0,1
2015,Julio,7,7/1/2015,Lesoto,1,2,0,3
2015,Julio,7,7/1/2015,Letonia,20,23,0,43
2015,Julio,7,7/1/2015,Lituania,24,18,0,42
2015,Julio,7,7/1/2015,Líbano,18,32,0,50
2015,Julio,7,7/1/2015,Liberia,0,1,0,1
2015,Julio,7,7/1/2015,Libia,0,1,0,1
2015,Julio,7,7/1/2015,Liechtenstein,6,1,0,7
2015,Julio,7,7/1/2015,Luxemburgo,13,9,0,22
2015,Julio,7,7/1/2015,Macedonia,4,5,0,9
2015,Julio,7,7/1/2015,Madagascar,1,0,0,1
2015,Julio,7,7/1/2015,Malasia,22,36,0,58
2015,Julio,7,7/1/2015,Malta,4,4,0,8
2015,Julio,7,7/1/2015,Marruecos,6,26,0,32
2015,Julio,7,7/1/2015,Mauricio,2,6,0,8
2015,Julio,7,7/1/2015,México,6424,10046,0,16470
2015,Julio,7,7/1/2015,República de Moldavia,4,3,0,7
2015,Julio,7,7/1/2015,Mónaco,0,1,0,1
2015,Julio,7,7/1/2015,Mongolia,0,1,0,1
2015,Julio,7,7/1/2015,Montenegro,2,2,0,4
2015,Julio,7,7/1/2015,Montserrat/Territorio Británico de Ultramar,1,0,0,1
2015,Julio,7,7/1/2015,Micronesia,0,1,0,1
2015,Julio,7,7/1/2015,Mozambique,0,2,0,2
2015,Julio,7,7/1/2015,Namibia,1,4,0,5
2015,Julio,7,7/1/2015,Nepal,2,8,0,10
2015,Julio,7,7/1/2015,Nicaragua,72,137,0,209
2015,Julio,7,7/1/2015,Nigeria,4,15,0,19
2015,Julio,7,7/1/2015,Noruega,219,258,0,477
2015,Julio,7,7/1/2015,Nueva Zelanda,116,164,0,280
2015,Julio,7,7/1/2015,Omán,0,5,0,5
2015,Julio,7,7/1/2015,Papúa Nueva Guinea,0,1,0,1
2015,Julio,7,7/1/2015,Pakistán,4,13,0,17
2015,Julio,7,7/1/2015,Panamá,2047,2633,0,4680
2015,Julio,7,7/1/2015,Paraguay,167,157,0,324
2015,Julio,7,7/1/2015,Perú,6018,6942,0,12960
2015,Julio,7,7/1/2015,Palestina,2,1,0,3
2015,Julio,7,7/1/2015,Polonia,117,184,0,301
2015,Julio,7,7/1/2015,Portugal,286,677,0,963
2015,Julio,7,7/1/2015,Puerto Rico/Territorio de Estados Unidos,1,1,0,2
2015,Julio,7,7/1/2015,Qatar,0,5,0,5
2015,Julio,7,7/1/2015,Reino Unido de Gran Bretaña e Irlanda del Norte,1619,2808,0,4427
2015,Julio,7,7/1/2015,República CentroÁfricana,1,0,0,1
2015,Julio,7,7/1/2015,Federación de Rusia,173,213,0,386
2015,Julio,7,7/1/2015,República Dominicana,494,809,0,1303
2015,Julio,7,7/1/2015,Rumania,65,86,0,151
2015,Julio,7,7/1/2015,Rwanda,2,1,0,3
2015,Julio,7,7/1/2015,San Cristóbal y Nevis,6,9,0,15
2015,Julio,7,7/1/2015,San Marino,2,1,0,3
2015,Julio,7,7/1/2015,San  Vicente y las Granadinas,4,2,0,6
2015,Julio,7,7/1/2015,Santa Lucia,6,6,0,12
2015,Julio,7,7/1/2015,Senegal,4,5,0,9
2015,Julio,7,7/1/2015,Serbia,15,18,0,33
2015,Julio,7,7/1/2015,Seychelles,0,1,0,1
2015,Julio,7,7/1/2015,Sierra Leona,0,1,0,1
2015,Julio,7,7/1/2015,Singapur,13,38,0,51
2015,Julio,7,7/1/2015,República Árabe Siria,0,4,0,4
2015,Julio,7,7/1/2015,Somalia,0,1,0,1
2015,Julio,7,7/1/2015,Sri Lanka,4,7,0,11
2015,Julio,7,7/1/2015,Sudáfrica,78,121,0,199
2015,Julio,7,7/1/2015,Sudán,2,10,0,12
2015,Julio,7,7/1/2015,Suecia,244,360,0,604
2015,Julio,7,7/1/2015,Suiza,923,1294,0,2217
2015,Julio,7,7/1/2015,Surinam,21,26,0,47
2015,Julio,7,7/1/2015,Suazilandia,0,3,0,3
2015,Julio,7,7/1/2015,Taiwán,78,84,0,162
2015,Julio,7,7/1/2015,República de Tayikistán,1,1,0,2
2015,Julio,7,7/1/2015,Tailandia,8,8,0,16
2015,Julio,7,7/1/2015,Togo,0,1,0,1
2015,Julio,7,7/1/2015,Trinidad y Tobago,86,109,0,195
2015,Julio,7,7/1/2015,Túnez,2,17,0,19
2015,Julio,7,7/1/2015,Turquía,54,186,0,240
2015,Julio,7,7/1/2015,Ucrania,41,57,0,98
2015,Julio,7,7/1/2015,Uganda,2,5,0,7
2015,Julio,7,7/1/2015,Uruguay,330,580,0,910
2015,Julio,7,7/1/2015,Uzbekistán,5,7,0,12
2015,Julio,7,7/1/2015,Venezuela,15020,17185,0,32205
2015,Julio,7,7/1/2015,Vietnam,6,4,0,10
2015,Julio,7,7/1/2015,República Árabe de Yemen,0,1,0,1
2015,Julio,7,7/1/2015,Zambia,0,3,0,3
2015,Julio,7,7/1/2015,Zimbabue,3,4,0,7
2015,Julio,7,7/1/2015,Islas Turcas y Caicos/Territorio Británico de Ultramar,1,0,0,1
2015,Julio,7,7/1/2015,Desconocido,43,111,0,154
2015,Agosto,8,8/1/2015,Afganistán,0,1,0,1
2015,Agosto,8,8/1/2015,Albania,2,6,0,8
2015,Agosto,8,8/1/2015,Alemania,2599,3218,0,5817
2015,Agosto,8,8/1/2015,Andorra,3,10,0,13
2015,Agosto,8,8/1/2015,Angola,0,1,0,1
2015,Agosto,8,8/1/2015,Antigua y Barbuda,1,10,0,11
2015,Agosto,8,8/1/2015,Países Bajos,1297,1987,0,3284
2015,Agosto,8,8/1/2015,Arabia Saudita,0,11,0,11
2015,Agosto,8,8/1/2015,Argelia,3,10,0,13
2015,Agosto,8,8/1/2015,Argentina,4203,5839,0,10042
2015,Agosto,8,8/1/2015,República de Armenia,2,2,0,4
2015,Agosto,8,8/1/2015,Aruba,2,0,0,2
2015,Agosto,8,8/1/2015,Australia,413,650,0,1063
2015,Agosto,8,8/1/2015,Austria,228,320,0,548
2015,Agosto,8,8/1/2015,Azerbaiyán,0,3,0,3
2015,Agosto,8,8/1/2015,Bahamas,12,12,0,24
2015,Agosto,8,8/1/2015,Bahréin,0,3,0,3
2015,Agosto,8,8/1/2015,Bangladesh,1,4,0,5
2015,Agosto,8,8/1/2015,Barbados,10,9,0,19
2015,Agosto,8,8/1/2015,República de Belarús,7,4,0,11
2015,Agosto,8,8/1/2015,Bélgica,275,471,0,746
2015,Agosto,8,8/1/2015,Belice,10,27,0,37
2015,Agosto,8,8/1/2015,Benín,0,2,0,2
2015,Agosto,8,8/1/2015,Bermudas/Territorio Británico de Ultramar,5,1,0,6
2015,Agosto,8,8/1/2015,Bolivia,638,737,0,1375
2015,Agosto,8,8/1/2015,Bosnia y Herzegovina,0,1,0,1
2015,Agosto,8,8/1/2015,Botsuana,1,1,0,2
2015,Agosto,8,8/1/2015,Brasil,4061,5929,0,9990
2015,Agosto,8,8/1/2015,Bulgaria,21,23,0,44
2015,Agosto,8,8/1/2015,Islas Caimán/Territorio Británico de Ultramar,3,5,0,8
2015,Agosto,8,8/1/2015,Camboya,1,3,0,4
2015,Agosto,8,8/1/2015,Camerún,0,7,0,7
2015,Agosto,8,8/1/2015,Canadá,1167,1833,0,3000
2015,Agosto,8,8/1/2015,Chad,0,1,0,1
2015,Agosto,8,8/1/2015,España,4089,7176,0,11265
2015,Agosto,8,8/1/2015,República Democrática del Congo,1,2,0,3
2015,Agosto,8,8/1/2015,República de Corea,260,564,0,824
2015,Agosto,8,8/1/2015,Costa de Marfil,0,3,0,3
2015,Agosto,8,8/1/2015,Costa Rica,958,1437,0,2395
2015,Agosto,8,8/1/2015,Croacia,18,46,0,64
2015,Agosto,8,8/1/2015,Cuba,273,475,0,748
2015,Agosto,8,8/1/2015,República Checa,31,59,0,90
2015,Agosto,8,8/1/2015,Chile,4391,5699,0,10090
2015,Agosto,8,8/1/2015,China,421,959,0,1380
2015,Agosto,8,8/1/2015,Chipre,6,10,0,16
2015,Agosto,8,8/1/2015,Dinamarca,77,145,0,222
2015,Agosto,8,8/1/2015,Dominica,0,9,0,9
2015,Agosto,8,8/1/2015,Ecuador,7444,9366,0,16810
2015,Agosto,8,8/1/2015,Egipto,12,27,0,39
2015,Agosto,8,8/1/2015,El Salvador,1149,1259,0,2408
2015,Agosto,8,8/1/2015,Emiratos Árabes,1,8,0,9
2015,Agosto,8,8/1/2015,Eslovaquia,18,20,0,38
2015,Agosto,8,8/1/2015,Eslovenia,13,31,0,44
2015,Agosto,8,8/1/2015,Estados Unidos de América,15117,25259,0,40376
2015,Agosto,8,8/1/2015,Estonia,5,6,0,11
2015,Agosto,8,8/1/2015,Etiopia,1,1,0,2
2015,Agosto,8,8/1/2015,Islas Fiji,0,2,0,2
2015,Agosto,8,8/1/2015,Filipinas,50,264,0,314
2015,Agosto,8,8/1/2015,Finlandia,44,50,0,94
2015,Agosto,8,8/1/2015,Francia,2166,3410,0,5576
2015,Agosto,8,8/1/2015,Gabón,0,1,0,1
2015,Agosto,8,8/1/2015,Georgia,2,3,0,5
2015,Agosto,8,8/1/2015,Ghana,2,14,0,16
2015,Agosto,8,8/1/2015,Granada,1,5,0,6
2015,Agosto,8,8/1/2015,Grecia,45,79,0,124
2015,Agosto,8,8/1/2015,Guatemala,534,1060,0,1594
2015,Agosto,8,8/1/2015,Guyana,12,17,0,29
2015,Agosto,8,8/1/2015,Guinea,0,1,0,1
2015,Agosto,8,8/1/2015,Guinea Ecuatorial,0,1,0,1
2015,Agosto,8,8/1/2015,Haití,5,14,0,19
2015,Agosto,8,8/1/2015,Honduras,257,432,0,689
2015,Agosto,8,8/1/2015,Hong Kong,2,3,0,5
2015,Agosto,8,8/1/2015,Hungría,31,29,0,60
2015,Agosto,8,8/1/2015,India,90,584,0,674
2015,Agosto,8,8/1/2015,Indonesia,18,37,0,55
2015,Agosto,8,8/1/2015,Irán,4,20,0,24
2015,Agosto,8,8/1/2015,República de Irlanda,159,252,0,411
2015,Agosto,8,8/1/2015,Islandia,3,8,0,11
2015,Agosto,8,8/1/2015,Israel,226,771,0,997
2015,Agosto,8,8/1/2015,Italia,1274,3093,0,4367
2015,Agosto,8,8/1/2015,Jamaica,28,43,0,71
2015,Agosto,8,8/1/2015,Japón,217,549,0,766
2015,Agosto,8,8/1/2015,Jordania,0,10,0,10
2015,Agosto,8,8/1/2015,Kazajistán,7,6,0,13
2015,Agosto,8,8/1/2015,Kenia,4,20,0,24
2015,Agosto,8,8/1/2015,Kirguistán,1,1,0,2
2015,Agosto,8,8/1/2015,Kuwait,1,6,0,7
2015,Agosto,8,8/1/2015,República de Kosovo,1,0,0,1
2015,Agosto,8,8/1/2015,República Democrática Popular  Lao,0,1,0,1
2015,Agosto,8,8/1/2015,Lesoto,1,0,0,1
2015,Agosto,8,8/1/2015,Letonia,11,10,0,21
2015,Agosto,8,8/1/2015,Lituania,21,24,0,45
2015,Agosto,8,8/1/2015,Líbano,26,41,0,67
2015,Agosto,8,8/1/2015,Liechtenstein,0,3,0,3
2015,Agosto,8,8/1/2015,Luxemburgo,13,17,0,30
2015,Agosto,8,8/1/2015,Macedonia,0,1,0,1
2015,Agosto,8,8/1/2015,Madagascar,1,0,0,1
2015,Agosto,8,8/1/2015,Malasia,23,46,0,69
2015,Agosto,8,8/1/2015,Malawi,3,5,0,8
2015,Agosto,8,8/1/2015,Malí,0,2,0,2
2015,Agosto,8,8/1/2015,Malta,5,7,0,12
2015,Agosto,8,8/1/2015,Marruecos,4,13,0,17
2015,Agosto,8,8/1/2015,Mauricio,0,1,0,1
2015,Agosto,8,8/1/2015,México,5266,9646,0,14912
2015,Agosto,8,8/1/2015,República de Moldavia,4,1,0,5
2015,Agosto,8,8/1/2015,Mónaco,2,3,0,5
2015,Agosto,8,8/1/2015,Mongolia,4,3,0,7
2015,Agosto,8,8/1/2015,Montenegro,1,3,0,4
2015,Agosto,8,8/1/2015,Montserrat/Territorio Británico de Ultramar,0,1,0,1
2015,Agosto,8,8/1/2015,Mozambique,1,2,0,3
2015,Agosto,8,8/1/2015,Myanmar,1,3,0,4
2015,Agosto,8,8/1/2015,Nepal,0,4,0,4
2015,Agosto,8,8/1/2015,Nicaragua,93,124,0,217
2015,Agosto,8,8/1/2015,Nigeria,13,13,0,26
2015,Agosto,8,8/1/2015,Noruega,88,155,0,243
2015,Agosto,8,8/1/2015,Nueva Zelanda,90,120,0,210
2015,Agosto,8,8/1/2015,Omán,0,2,0,2
2015,Agosto,8,8/1/2015,Papúa Nueva Guinea,1,2,0,3
2015,Agosto,8,8/1/2015,Pakistán,7,24,0,31
2015,Agosto,8,8/1/2015,Panamá,2333,2975,0,5308
2015,Agosto,8,8/1/2015,Paraguay,275,234,0,509
2015,Agosto,8,8/1/2015,Perú,5665,7177,0,12842
2015,Agosto,8,8/1/2015,Palestina,0,1,0,1
2015,Agosto,8,8/1/2015,Polonia,160,193,0,353
2015,Agosto,8,8/1/2015,Portugal,347,609,0,956
2015,Agosto,8,8/1/2015,Qatar,0,3,0,3
2015,Agosto,8,8/1/2015,Reino Unido de Gran Bretaña e Irlanda del Norte,1354,2474,0,3828
2015,Agosto,8,8/1/2015,República CentroÁfricana,5,0,0,5
2015,Agosto,8,8/1/2015,Federación de Rusia,193,216,0,409
2015,Agosto,8,8/1/2015,República Dominicana,705,944,0,1649
2015,Agosto,8,8/1/2015,Rumania,54,83,0,137
2015,Agosto,8,8/1/2015,San Cristóbal y Nevis,1,5,0,6
2015,Agosto,8,8/1/2015,San Marino,0,1,0,1
2015,Agosto,8,8/1/2015,San  Vicente y las Granadinas,2,8,0,10
2015,Agosto,8,8/1/2015,Santa Lucia,3,9,0,12
2015,Agosto,8,8/1/2015,Santa Sede/Ciudad del Vaticano,0,2,0,2
2015,Agosto,8,8/1/2015,Senegal,1,4,0,5
2015,Agosto,8,8/1/2015,Serbia,12,22,0,34
2015,Agosto,8,8/1/2015,Sierra Leona,0,5,0,5
2015,Agosto,8,8/1/2015,Singapur,17,28,0,45
2015,Agosto,8,8/1/2015,República Árabe Siria,1,2,0,3
2015,Agosto,8,8/1/2015,Sri Lanka,0,2,0,2
2015,Agosto,8,8/1/2015,Sudáfrica,69,139,0,208
2015,Agosto,8,8/1/2015,Suecia,138,229,0,367
2015,Agosto,8,8/1/2015,Suiza,489,703,0,1192
2015,Agosto,8,8/1/2015,Surinam,23,25,0,48
2015,Agosto,8,8/1/2015,Taiwán,63,83,0,146
2015,Agosto,8,8/1/2015,Tailandia,11,7,0,18
2015,Agosto,8,8/1/2015,Tanzania,1,4,0,5
2015,Agosto,8,8/1/2015,Togo,0,1,0,1
2015,Agosto,8,8/1/2015,Trinidad y Tobago,63,94,0,157
2015,Agosto,8,8/1/2015,Túnez,2,5,0,7
2015,Agosto,8,8/1/2015,Turquía,47,107,0,154
2015,Agosto,8,8/1/2015,Ucrania,22,39,0,61
2015,Agosto,8,8/1/2015,Uganda,7,8,0,15
2015,Agosto,8,8/1/2015,Uruguay,387,635,0,1022
2015,Agosto,8,8/1/2015,Uzbekistán,2,0,0,2
2015,Agosto,8,8/1/2015,Venezuela,19595,20718,0,40313
2015,Agosto,8,8/1/2015,Vietnam,9,9,0,18
2015,Agosto,8,8/1/2015,Islas Vírgenes Británicas/Territorio Británico de Ultramar,0,1,0,1
2015,Agosto,8,8/1/2015,Zambia,0,1,0,1
2015,Agosto,8,8/1/2015,Zimbabue,0,6,0,6
2015,Agosto,8,8/1/2015,Islas Turcas y Caicos/Territorio Británico de Ultramar,0,1,0,1
2015,Agosto,8,8/1/2015,Desconocido,65,128,0,193
2015,Septiembre,9,9/1/2015,Afganistán,1,2,0,3
2015,Septiembre,9,9/1/2015,Albania,3,3,0,6
2015,Septiembre,9,9/1/2015,Alemania,1616,2528,0,4144
2015,Septiembre,9,9/1/2015,Andorra,2,10,0,12
2015,Septiembre,9,9/1/2015,Angola,1,3,0,4
2015,Septiembre,9,9/1/2015,Antigua y Barbuda,1,12,0,13
2015,Septiembre,9,9/1/2015,Países Bajos,1164,1918,0,3082
2015,Septiembre,9,9/1/2015,Arabia Saudita,2,23,0,25
2015,Septiembre,9,9/1/2015,Argelia,2,9,0,11
2015,Septiembre,9,9/1/2015,Argentina,4268,5560,0,9828
2015,Septiembre,9,9/1/2015,República de Armenia,1,4,0,5
2015,Septiembre,9,9/1/2015,Aruba,2,2,0,4
2015,Septiembre,9,9/1/2015,Australia,442,642,0,1084
2015,Septiembre,9,9/1/2015,Austria,141,268,0,409
2015,Septiembre,9,9/1/2015,Azerbaiyán,1,8,0,9
2015,Septiembre,9,9/1/2015,Bahamas,5,15,0,20
2015,Septiembre,9,9/1/2015,Bahréin,3,14,0,17
2015,Septiembre,9,9/1/2015,Bangladesh,3,14,0,17
2015,Septiembre,9,9/1/2015,Barbados,3,12,0,15
2015,Septiembre,9,9/1/2015,República de Belarús,2,7,0,9
2015,Septiembre,9,9/1/2015,Bélgica,171,378,0,549
2015,Septiembre,9,9/1/2015,Belice,5,15,0,20
2015,Septiembre,9,9/1/2015,Benín,0,8,0,8
2015,Septiembre,9,9/1/2015,Bermudas/Territorio Británico de Ultramar,0,2,0,2
2015,Septiembre,9,9/1/2015,Bolivia,573,718,0,1291
2015,Septiembre,9,9/1/2015,Bosnia y Herzegovina,0,3,0,3
2015,Septiembre,9,9/1/2015,Botsuana,1,2,0,3
2015,Septiembre,9,9/1/2015,Brasil,5449,6597,0,12046
2015,Septiembre,9,9/1/2015,Bulgaria,32,32,0,64
2015,Septiembre,9,9/1/2015,Burkina Faso,1,1,0,2
2015,Septiembre,9,9/1/2015,Burundi,0,1,0,1
2015,Septiembre,9,9/1/2015,Bután,1,1,0,2
2015,Septiembre,9,9/1/2015,Islas Caimán/Territorio Británico de Ultramar,0,3,0,3
2015,Septiembre,9,9/1/2015,Camboya,3,3,0,6
2015,Septiembre,9,9/1/2015,Camerún,1,10,0,11
2015,Septiembre,9,9/1/2015,Canadá,748,1478,0,2226
2015,Septiembre,9,9/1/2015,Chad,0,3,0,3
2015,Septiembre,9,9/1/2015,España,2966,6997,0,9963
2015,Septiembre,9,9/1/2015,República Del Congo,0,4,0,4
2015,Septiembre,9,9/1/2015,República Democrática del Congo,4,5,0,9
2015,Septiembre,9,9/1/2015,República de Corea,193,496,0,689
2015,Septiembre,9,9/1/2015,Costa de Marfil,2,11,0,13
2015,Septiembre,9,9/1/2015,Costa Rica,994,1479,0,2473
2015,Septiembre,9,9/1/2015,Croacia,19,45,0,64
2015,Septiembre,9,9/1/2015,Cuba,371,587,0,958
2015,Septiembre,9,9/1/2015,República Checa,30,52,0,82
2015,Septiembre,9,9/1/2015,Chile,4083,5190,0,9273
2015,Septiembre,9,9/1/2015,China,340,855,0,1195
2015,Septiembre,9,9/1/2015,Chipre,4,6,0,10
2015,Septiembre,9,9/1/2015,Dinamarca,75,169,0,244
2015,Septiembre,9,9/1/2015,Dominica,0,2,0,2
2015,Septiembre,9,9/1/2015,Ecuador,5651,8095,0,13746
2015,Septiembre,9,9/1/2015,Egipto,4,33,0,37
2015,Septiembre,9,9/1/2015,El Salvador,814,1060,0,1874
2015,Septiembre,9,9/1/2015,Emiratos Árabes,0,8,0,8
2015,Septiembre,9,9/1/2015,Eritrea,2,1,0,3
2015,Septiembre,9,9/1/2015,Eslovaquia,17,23,0,40
2015,Septiembre,9,9/1/2015,Eslovenia,24,23,0,47
2015,Septiembre,9,9/1/2015,Estados Unidos de América,10284,20625,0,30909
2015,Septiembre,9,9/1/2015,Estonia,7,7,0,14
2015,Septiembre,9,9/1/2015,Etiopia,5,7,0,12
2015,Septiembre,9,9/1/2015,Filipinas,40,178,0,218
2015,Septiembre,9,9/1/2015,Finlandia,32,83,0,115
2015,Septiembre,9,9/1/2015,Francia,1158,2243,0,3401
2015,Septiembre,9,9/1/2015,Gambia,0,1,0,1
2015,Septiembre,9,9/1/2015,Georgia,2,10,0,12
2015,Septiembre,9,9/1/2015,Ghana,1,14,0,15
2015,Septiembre,9,9/1/2015,Granada,0,4,0,4
2015,Septiembre,9,9/1/2015,Grecia,23,66,0,89
2015,Septiembre,9,9/1/2015,Guatemala,593,1274,0,1867
2015,Septiembre,9,9/1/2015,Guyana,7,19,0,26
2015,Septiembre,9,9/1/2015,Guinea,0,2,0,2
2015,Septiembre,9,9/1/2015,Guinea Ecuatorial,0,1,0,1
2015,Septiembre,9,9/1/2015,Haití,8,25,0,33
2015,Septiembre,9,9/1/2015,Honduras,344,555,0,899
2015,Septiembre,9,9/1/2015,Hong Kong,4,1,0,5
2015,Septiembre,9,9/1/2015,Hungría,27,56,0,83
2015,Septiembre,9,9/1/2015,India,90,585,0,675
2015,Septiembre,9,9/1/2015,Indonesia,9,27,0,36
2015,Septiembre,9,9/1/2015,Iraq,0,5,0,5
2015,Septiembre,9,9/1/2015,Irán,5,18,0,23
2015,Septiembre,9,9/1/2015,República de Irlanda,90,254,0,344
2015,Septiembre,9,9/1/2015,Islandia,4,8,0,12
2015,Septiembre,9,9/1/2015,Israel,199,646,0,845
2015,Septiembre,9,9/1/2015,Italia,996,2249,0,3245
2015,Septiembre,9,9/1/2015,Jamaica,22,63,0,85
2015,Septiembre,9,9/1/2015,Japón,226,549,0,775
2015,Septiembre,9,9/1/2015,Jordania,7,16,0,23
2015,Septiembre,9,9/1/2015,Kazajistán,4,2,0,6
2015,Septiembre,9,9/1/2015,Kenia,15,24,0,39
2015,Septiembre,9,9/1/2015,Kiribati,0,5,0,5
2015,Septiembre,9,9/1/2015,Kirguistán,0,2,0,2
2015,Septiembre,9,9/1/2015,Kuwait,2,9,0,11
2015,Septiembre,9,9/1/2015,Letonia,4,14,0,18
2015,Septiembre,9,9/1/2015,Lituania,25,17,0,42
2015,Septiembre,9,9/1/2015,Líbano,25,36,0,61
2015,Septiembre,9,9/1/2015,Liechtenstein,2,0,0,2
2015,Septiembre,9,9/1/2015,Luxemburgo,9,8,0,17
2015,Septiembre,9,9/1/2015,Macedonia,0,1,0,1
2015,Septiembre,9,9/1/2015,Madagascar,0,6,0,6
2015,Septiembre,9,9/1/2015,Malasia,17,72,0,89
2015,Septiembre,9,9/1/2015,Maldivas,0,3,0,3
2015,Septiembre,9,9/1/2015,Malta,4,8,0,12
2015,Septiembre,9,9/1/2015,Marruecos,12,20,0,32
2015,Septiembre,9,9/1/2015,Mauricio,1,4,0,5
2015,Septiembre,9,9/1/2015,México,4628,8707,0,13335
2015,Septiembre,9,9/1/2015,República de Moldavia,0,1,0,1
2015,Septiembre,9,9/1/2015,Mónaco,1,1,0,2
2015,Septiembre,9,9/1/2015,Mongolia,7,5,0,12
2015,Septiembre,9,9/1/2015,Montenegro,3,4,0,7
2015,Septiembre,9,9/1/2015,Mozambique,3,8,0,11
2015,Septiembre,9,9/1/2015,Myanmar,0,1,0,1
2015,Septiembre,9,9/1/2015,Namibia,1,2,0,3
2015,Septiembre,9,9/1/2015,Nepal,3,7,0,10
2015,Septiembre,9,9/1/2015,Nicaragua,120,155,0,275
2015,Septiembre,9,9/1/2015,Nigeria,2,18,0,20
2015,Septiembre,9,9/1/2015,Níger,0,2,0,2
2015,Septiembre,9,9/1/2015,Noruega,60,156,0,216
2015,Septiembre,9,9/1/2015,Nueva Zelanda,65,121,0,186
2015,Septiembre,9,9/1/2015,Omán,0,5,0,5
2015,Septiembre,9,9/1/2015,Pakistán,4,14,0,18
2015,Septiembre,9,9/1/2015,Panamá,2620,2862,0,5482
2015,Septiembre,9,9/1/2015,Paraguay,314,363,0,677
2015,Septiembre,9,9/1/2015,Perú,5044,6220,0,11264
2015,Septiembre,9,9/1/2015,Palestina,6,6,0,12
2015,Septiembre,9,9/1/2015,Polonia,133,228,0,361
2015,Septiembre,9,9/1/2015,Portugal,283,628,0,911
2015,Septiembre,9,9/1/2015,Qatar,1,8,0,9
2015,Septiembre,9,9/1/2015,Reino Unido de Gran Bretaña e Irlanda del Norte,1034,2123,0,3157
2015,Septiembre,9,9/1/2015,Federación de Rusia,190,292,0,482
2015,Septiembre,9,9/1/2015,República Dominicana,575,887,0,1462
2015,Septiembre,9,9/1/2015,Rumania,56,90,0,146
2015,Septiembre,9,9/1/2015,San Cristóbal y Nevis,1,2,0,3
2015,Septiembre,9,9/1/2015,Samoa Occidental,1,0,0,1
2015,Septiembre,9,9/1/2015,San Marino,0,2,0,2
2015,Septiembre,9,9/1/2015,San  Vicente y las Granadinas,0,4,0,4
2015,Septiembre,9,9/1/2015,Santa Lucia,4,8,0,12
2015,Septiembre,9,9/1/2015,Santa Sede/Ciudad del Vaticano,0,1,0,1
2015,Septiembre,9,9/1/2015,Senegal,1,5,0,6
2015,Septiembre,9,9/1/2015,Serbia,3,9,0,12
2015,Septiembre,9,9/1/2015,Seychelles,2,1,0,3
2015,Septiembre,9,9/1/2015,Sierra Leona,0,1,0,1
2015,Septiembre,9,9/1/2015,Singapur,21,22,0,43
2015,Septiembre,9,9/1/2015,República Árabe Siria,0,5,0,5
2015,Septiembre,9,9/1/2015,Sri Lanka,2,5,0,7
2015,Septiembre,9,9/1/2015,Sudáfrica,49,118,0,167
2015,Septiembre,9,9/1/2015,Sudán,0,4,0,4
2015,Septiembre,9,9/1/2015,Suecia,143,275,0,418
2015,Septiembre,9,9/1/2015,Suiza,332,630,0,962
2015,Septiembre,9,9/1/2015,Surinam,25,28,0,53
2015,Septiembre,9,9/1/2015,Suazilandia,0,2,0,2
2015,Septiembre,9,9/1/2015,Taiwán,73,112,0,185
2015,Septiembre,9,9/1/2015,Tailandia,12,17,0,29
2015,Septiembre,9,9/1/2015,Tanzania,2,1,0,3
2015,Septiembre,9,9/1/2015,República Democrática de Timor Oriental,0,1,0,1
2015,Septiembre,9,9/1/2015,Togo,0,2,0,2
2015,Septiembre,9,9/1/2015,Trinidad y Tobago,31,73,0,104
2015,Septiembre,9,9/1/2015,Túnez,7,11,0,18
2015,Septiembre,9,9/1/2015,Turquía,40,145,0,185
2015,Septiembre,9,9/1/2015,Ucrania,24,33,0,57
2015,Septiembre,9,9/1/2015,Uganda,2,8,0,10
2015,Septiembre,9,9/1/2015,Uruguay,392,614,0,1006
2015,Septiembre,9,9/1/2015,Uzbekistán,1,1,0,2
2015,Septiembre,9,9/1/2015,Venezuela,13037,14382,0,27419
2015,Septiembre,9,9/1/2015,Vietnam,2,5,0,7
2015,Septiembre,9,9/1/2015,República Árabe de Yemen,0,1,0,1
2015,Septiembre,9,9/1/2015,Zambia,6,8,0,14
2015,Septiembre,9,9/1/2015,Zimbabue,2,19,0,21
2015,Septiembre,9,9/1/2015,Anguila/Territorio Británico de Ultramar,0,1,0,1
2015,Septiembre,9,9/1/2015,Desconocido,78,170,0,248
2015,Octubre,10,10/1/2015,Albania,0,4,0,4
2015,Octubre,10,10/1/2015,Alemania,1787,2942,0,4729
2015,Octubre,10,10/1/2015,Andorra,1,8,0,9
2015,Octubre,10,10/1/2015,Angola,0,2,0,2
2015,Octubre,10,10/1/2015,Antigua y Barbuda,6,13,0,19
2015,Octubre,10,10/1/2015,Países Bajos,1454,2255,0,3709
2015,Octubre,10,10/1/2015,Arabia Saudita,0,6,0,6
2015,Octubre,10,10/1/2015,Argelia,1,10,0,11
2015,Octubre,10,10/1/2015,Argentina,4074,5774,0,9848
2015,Octubre,10,10/1/2015,República de Armenia,1,0,0,1
2015,Octubre,10,10/1/2015,Australia,420,765,0,1185
2015,Octubre,10,10/1/2015,Austria,124,247,0,371
2015,Octubre,10,10/1/2015,Azerbaiyán,3,10,0,13
2015,Octubre,10,10/1/2015,Bahamas,8,11,0,19
2015,Octubre,10,10/1/2015,Bahréin,0,2,0,2
2015,Octubre,10,10/1/2015,Bangladesh,1,3,0,4
2015,Octubre,10,10/1/2015,Barbados,15,28,0,43
2015,Octubre,10,10/1/2015,República de Belarús,14,13,0,27
2015,Octubre,10,10/1/2015,Bélgica,188,463,0,651
2015,Octubre,10,10/1/2015,Belice,6,16,0,22
2015,Octubre,10,10/1/2015,Benín,0,3,0,3
2015,Octubre,10,10/1/2015,Bermudas/Territorio Británico de Ultramar,6,8,0,14
2015,Octubre,10,10/1/2015,Bolivia,673,838,0,1511
2015,Octubre,10,10/1/2015,Bosnia y Herzegovina,2,2,0,4
2015,Octubre,10,10/1/2015,Brasil,6129,6863,0,12992
2015,Octubre,10,10/1/2015,Bulgaria,23,35,0,58
2015,Octubre,10,10/1/2015,Burundi,2,0,0,2
2015,Octubre,10,10/1/2015,Cabo Verde,0,1,0,1
2015,Octubre,10,10/1/2015,Islas Caimán/Territorio Británico de Ultramar,4,0,0,4
2015,Octubre,10,10/1/2015,Camerún,0,4,0,4
2015,Octubre,10,10/1/2015,Canadá,990,1754,0,2744
2015,Octubre,10,10/1/2015,Chad,1,2,0,3
2015,Octubre,10,10/1/2015,España,2899,6635,0,9534
2015,Octubre,10,10/1/2015,República Democrática del Congo,1,3,0,4
2015,Octubre,10,10/1/2015,República de Corea,211,537,0,748
2015,Octubre,10,10/1/2015,Costa de Marfil,0,2,0,2
2015,Octubre,10,10/1/2015,Costa Rica,1085,1501,0,2586
2015,Octubre,10,10/1/2015,Croacia,11,63,0,74
2015,Octubre,10,10/1/2015,Cuba,337,559,0,896
2015,Octubre,10,10/1/2015,República Checa,39,102,0,141
2015,Octubre,10,10/1/2015,Chile,4442,5180,0,9622
2015,Octubre,10,10/1/2015,China,351,799,0,1150
2015,Octubre,10,10/1/2015,Chipre,1,4,0,5
2015,Octubre,10,10/1/2015,Dinamarca,110,242,0,352
2015,Octubre,10,10/1/2015,Dominica,3,3,0,6
2015,Octubre,10,10/1/2015,Ecuador,6796,8800,0,15596
2015,Octubre,10,10/1/2015,Egipto,11,15,0,26
2015,Octubre,10,10/1/2015,El Salvador,957,1174,0,2131
2015,Octubre,10,10/1/2015,Emiratos Árabes,0,6,0,6
2015,Octubre,10,10/1/2015,Eslovaquia,27,36,0,63
2015,Octubre,10,10/1/2015,Eslovenia,12,29,0,41
2015,Octubre,10,10/1/2015,Estados Unidos de América,10516,20838,0,31354
2015,Octubre,10,10/1/2015,Estonia,7,19,0,26
2015,Octubre,10,10/1/2015,Etiopia,0,1,0,1
2015,Octubre,10,10/1/2015,Filipinas,31,277,0,308
2015,Octubre,10,10/1/2015,Finlandia,53,99,0,152
2015,Octubre,10,10/1/2015,Francia,1456,2771,0,4227
2015,Octubre,10,10/1/2015,Gambia,1,0,0,1
2015,Octubre,10,10/1/2015,Georgia,2,5,0,7
2015,Octubre,10,10/1/2015,Ghana,0,2,0,2
2015,Octubre,10,10/1/2015,Granada,2,6,0,8
2015,Octubre,10,10/1/2015,Grecia,25,81,0,106
2015,Octubre,10,10/1/2015,Guatemala,668,1217,0,1885
2015,Octubre,10,10/1/2015,Guyana,13,19,0,32
2015,Octubre,10,10/1/2015,Guinea,1,2,0,3
2015,Octubre,10,10/1/2015,Guinea Ecuatorial,1,0,0,1
2015,Octubre,10,10/1/2015,Haití,11,30,0,41
2015,Octubre,10,10/1/2015,Honduras,443,502,0,945
2015,Octubre,10,10/1/2015,Hong Kong,12,4,0,16
2015,Octubre,10,10/1/2015,Hungría,47,68,0,115
2015,Octubre,10,10/1/2015,India,54,466,0,520
2015,Octubre,10,10/1/2015,Indonesia,9,40,0,49
2015,Octubre,10,10/1/2015,Iraq,0,1,0,1
2015,Octubre,10,10/1/2015,Irán,0,20,0,20
2015,Octubre,10,10/1/2015,República de Irlanda,136,213,0,349
2015,Octubre,10,10/1/2015,Islandia,13,13,0,26
2015,Octubre,10,10/1/2015,Israel,137,583,0,720
2015,Octubre,10,10/1/2015,Italia,749,2312,0,3061
2015,Octubre,10,10/1/2015,Jamaica,56,61,0,117
2015,Octubre,10,10/1/2015,Japón,134,560,0,694
2015,Octubre,10,10/1/2015,Jordania,1,2,0,3
2015,Octubre,10,10/1/2015,Kazajistán,6,6,0,12
2015,Octubre,10,10/1/2015,Kenia,6,6,0,12
2015,Octubre,10,10/1/2015,Kiribati,0,1,0,1
2015,Octubre,10,10/1/2015,Kirguistán,1,6,0,7
2015,Octubre,10,10/1/2015,Kuwait,0,2,0,2
2015,Octubre,10,10/1/2015,República de Kosovo,0,1,0,1
2015,Octubre,10,10/1/2015,Letonia,17,21,0,38
2015,Octubre,10,10/1/2015,Lituania,35,30,0,65
2015,Octubre,10,10/1/2015,Líbano,15,42,0,57
2015,Octubre,10,10/1/2015,Liechtenstein,1,2,0,3
2015,Octubre,10,10/1/2015,Luxemburgo,11,21,0,32
2015,Octubre,10,10/1/2015,Macedonia,0,3,0,3
2015,Octubre,10,10/1/2015,Madagascar,2,2,0,4
2015,Octubre,10,10/1/2015,Malasia,21,40,0,61
2015,Octubre,10,10/1/2015,Malí,2,2,0,4
2015,Octubre,10,10/1/2015,Malta,3,8,0,11
2015,Octubre,10,10/1/2015,Marruecos,8,12,0,20
2015,Octubre,10,10/1/2015,Mauricio,2,4,0,6
2015,Octubre,10,10/1/2015,México,4535,8025,0,12560
2015,Octubre,10,10/1/2015,Mónaco,0,1,0,1
2015,Octubre,10,10/1/2015,Mongolia,1,0,0,1
2015,Octubre,10,10/1/2015,Micronesia,0,1,0,1
2015,Octubre,10,10/1/2015,Mozambique,1,1,0,2
2015,Octubre,10,10/1/2015,Myanmar,1,2,0,3
2015,Octubre,10,10/1/2015,Namibia,0,1,0,1
2015,Octubre,10,10/1/2015,Nepal,1,13,0,14
2015,Octubre,10,10/1/2015,Nicaragua,107,120,0,227
2015,Octubre,10,10/1/2015,Nigeria,1,7,0,8
2015,Octubre,10,10/1/2015,Noruega,117,173,0,290
2015,Octubre,10,10/1/2015,Nueva Zelanda,89,145,0,234
2015,Octubre,10,10/1/2015,Pakistán,8,16,0,24
2015,Octubre,10,10/1/2015,Panamá,3122,3462,0,6584
2015,Octubre,10,10/1/2015,Paraguay,385,286,0,671
2015,Octubre,10,10/1/2015,Perú,6556,7823,0,14379
2015,Octubre,10,10/1/2015,Palestina,0,3,0,3
2015,Octubre,10,10/1/2015,Polonia,136,264,0,400
2015,Octubre,10,10/1/2015,Portugal,343,675,0,1018
2015,Octubre,10,10/1/2015,Qatar,0,4,0,4
2015,Octubre,10,10/1/2015,Reino Unido de Gran Bretaña e Irlanda del Norte,1000,2301,0,3301
2015,Octubre,10,10/1/2015,Federación de Rusia,233,314,0,547
2015,Octubre,10,10/1/2015,República Dominicana,538,713,0,1251
2015,Octubre,10,10/1/2015,Rumania,51,112,0,163
2015,Octubre,10,10/1/2015,Rwanda,1,0,0,1
2015,Octubre,10,10/1/2015,San Cristóbal y Nevis,2,4,0,6
2015,Octubre,10,10/1/2015,Samoa Occidental,1,0,0,1
2015,Octubre,10,10/1/2015,San  Vicente y las Granadinas,3,6,0,9
2015,Octubre,10,10/1/2015,Santa Lucia,4,11,0,15
2015,Octubre,10,10/1/2015,Senegal,0,3,0,3
2015,Octubre,10,10/1/2015,Serbia,1,6,0,7
2015,Octubre,10,10/1/2015,Singapur,21,22,0,43
2015,Octubre,10,10/1/2015,República Árabe Siria,1,2,0,3
2015,Octubre,10,10/1/2015,Sri Lanka,0,3,0,3
2015,Octubre,10,10/1/2015,Sudáfrica,43,98,0,141
2015,Octubre,10,10/1/2015,Suecia,216,361,0,577
2015,Octubre,10,10/1/2015,Suiza,476,839,0,1315
2015,Octubre,10,10/1/2015,Surinam,20,48,0,68
2015,Octubre,10,10/1/2015,Taiwán,123,144,0,267
2015,Octubre,10,10/1/2015,República de Tayikistán,0,1,0,1
2015,Octubre,10,10/1/2015,Tailandia,45,43,0,88
2015,Octubre,10,10/1/2015,Tanzania,1,1,0,2
2015,Octubre,10,10/1/2015,Togo,1,1,0,2
2015,Octubre,10,10/1/2015,Trinidad y Tobago,43,82,0,125
2015,Octubre,10,10/1/2015,Túnez,1,4,0,5
2015,Octubre,10,10/1/2015,Turquía,33,148,0,181
2015,Octubre,10,10/1/2015,Ucrania,38,52,0,90
2015,Octubre,10,10/1/2015,Uganda,2,1,0,3
2015,Octubre,10,10/1/2015,Uruguay,378,570,0,948
2015,Octubre,10,10/1/2015,Uzbekistán,1,4,0,5
2015,Octubre,10,10/1/2015,Venezuela,12192,13225,0,25417
2015,Octubre,10,10/1/2015,Vietnam,10,1,0,11
2015,Octubre,10,10/1/2015,República Árabe de Yemen,0,2,0,2
2015,Octubre,10,10/1/2015,Zambia,2,2,0,4
2015,Octubre,10,10/1/2015,Zimbabue,0,6,0,6
2015,Octubre,10,10/1/2015,Anguila/Territorio Británico de Ultramar,0,1,0,1
2015,Octubre,10,10/1/2015,Desconocido,54,121,0,175
2015,Noviembre,11,11/1/2015,Albania,2,5,0,7
2015,Noviembre,11,11/1/2015,Alemania,1803,3218,0,5021
2015,Noviembre,11,11/1/2015,Andorra,1,10,0,11
2015,Noviembre,11,11/1/2015,Antigua y Barbuda,8,18,0,26
2015,Noviembre,11,11/1/2015,Países Bajos,1308,2116,0,3424
2015,Noviembre,11,11/1/2015,Arabia Saudita,1,9,0,10
2015,Noviembre,11,11/1/2015,Argelia,3,2,0,5
2015,Noviembre,11,11/1/2015,Argentina,4431,6296,0,10727
2015,Noviembre,11,11/1/2015,República de Armenia,0,2,0,2
2015,Noviembre,11,11/1/2015,Aruba,2,1,0,3
2015,Noviembre,11,11/1/2015,Australia,526,859,0,1385
2015,Noviembre,11,11/1/2015,Austria,159,334,0,493
2015,Noviembre,11,11/1/2015,Azerbaiyán,0,2,0,2
2015,Noviembre,11,11/1/2015,Bahamas,7,8,0,15
2015,Noviembre,11,11/1/2015,Bahréin,2,1,0,3
2015,Noviembre,11,11/1/2015,Bangladesh,0,4,0,4
2015,Noviembre,11,11/1/2015,Barbados,12,14,0,26
2015,Noviembre,11,11/1/2015,República de Belarús,5,6,0,11
2015,Noviembre,11,11/1/2015,Bélgica,238,549,0,787
2015,Noviembre,11,11/1/2015,Belice,16,20,0,36
2015,Noviembre,11,11/1/2015,Benín,1,3,0,4
2015,Noviembre,11,11/1/2015,Bermudas/Territorio Británico de Ultramar,2,7,0,9
2015,Noviembre,11,11/1/2015,Bolivia,708,853,0,1561
2015,Noviembre,11,11/1/2015,Bosnia y Herzegovina,2,3,0,5
2015,Noviembre,11,11/1/2015,Brasil,5228,6904,0,12132
2015,Noviembre,11,11/1/2015,Bulgaria,31,41,0,72
2015,Noviembre,11,11/1/2015,Burundi,0,1,0,1
2015,Noviembre,11,11/1/2015,Cabo Verde,0,3,0,3
2015,Noviembre,11,11/1/2015,Islas Caimán/Territorio Británico de Ultramar,2,4,0,6
2015,Noviembre,11,11/1/2015,Camerún,1,9,0,10
2015,Noviembre,11,11/1/2015,Canadá,1203,2085,0,3288
2015,Noviembre,11,11/1/2015,España,3406,7807,0,11213
2015,Noviembre,11,11/1/2015,República Democrática del Congo,1,5,0,6
2015,Noviembre,11,11/1/2015,República de Corea,277,620,0,897
2015,Noviembre,11,11/1/2015,Costa de Marfil,0,5,0,5
2015,Noviembre,11,11/1/2015,Costa Rica,1156,1716,0,2872
2015,Noviembre,11,11/1/2015,Croacia,11,70,0,81
2015,Noviembre,11,11/1/2015,Cuba,397,627,0,1024
2015,Noviembre,11,11/1/2015,República Checa,70,144,0,214
2015,Noviembre,11,11/1/2015,Chile,3633,5310,0,8943
2015,Noviembre,11,11/1/2015,China,328,932,0,1260
2015,Noviembre,11,11/1/2015,Chipre,4,3,0,7
2015,Noviembre,11,11/1/2015,Dinamarca,127,246,0,373
2015,Noviembre,11,11/1/2015,Dominica,3,9,0,12
2015,Noviembre,11,11/1/2015,Ecuador,5228,7535,0,12763
2015,Noviembre,11,11/1/2015,Egipto,3,24,0,27
2015,Noviembre,11,11/1/2015,El Salvador,1114,1437,0,2551
2015,Noviembre,11,11/1/2015,Emiratos Árabes,0,16,0,16
2015,Noviembre,11,11/1/2015,Eritrea,0,1,0,1
2015,Noviembre,11,11/1/2015,Eslovaquia,17,34,0,51
2015,Noviembre,11,11/1/2015,Eslovenia,16,36,0,52
2015,Noviembre,11,11/1/2015,Estados Unidos de América,12530,24026,0,36556
2015,Noviembre,11,11/1/2015,Estonia,8,17,0,25
2015,Noviembre,11,11/1/2015,Etiopia,2,5,0,7
2015,Noviembre,11,11/1/2015,Islas Fiji,0,1,0,1
2015,Noviembre,11,11/1/2015,Filipinas,41,310,0,351
2015,Noviembre,11,11/1/2015,Finlandia,87,121,0,208
2015,Noviembre,11,11/1/2015,Francia,1597,2913,0,4510
2015,Noviembre,11,11/1/2015,Georgia,5,5,0,10
2015,Noviembre,11,11/1/2015,Ghana,2,6,0,8
2015,Noviembre,11,11/1/2015,Granada,2,7,0,9
2015,Noviembre,11,11/1/2015,Grecia,18,92,0,110
2015,Noviembre,11,11/1/2015,Guatemala,806,1377,0,2183
2015,Noviembre,11,11/1/2015,Guyana,9,16,0,25
2015,Noviembre,11,11/1/2015,Guinea,0,1,0,1
2015,Noviembre,11,11/1/2015,Guinea Ecuatorial,3,0,0,3
2015,Noviembre,11,11/1/2015,Guinea Bissau,0,1,0,1
2015,Noviembre,11,11/1/2015,Haití,14,32,0,46
2015,Noviembre,11,11/1/2015,Honduras,373,558,0,931
2015,Noviembre,11,11/1/2015,Hong Kong,4,3,0,7
2015,Noviembre,11,11/1/2015,Hungría,48,49,0,97
2015,Noviembre,11,11/1/2015,India,103,559,0,662
2015,Noviembre,11,11/1/2015,Indonesia,16,63,0,79
2015,Noviembre,11,11/1/2015,Irán,2,14,0,16
2015,Noviembre,11,11/1/2015,República de Irlanda,147,275,0,422
2015,Noviembre,11,11/1/2015,Islandia,5,8,0,13
2015,Noviembre,11,11/1/2015,Israel,133,600,0,733
2015,Noviembre,11,11/1/2015,Italia,756,2755,0,3511
2015,Noviembre,11,11/1/2015,Jamaica,24,44,0,68
2015,Noviembre,11,11/1/2015,Japón,153,607,0,760
2015,Noviembre,11,11/1/2015,Jordania,3,9,0,12
2015,Noviembre,11,11/1/2015,Kazajistán,3,15,0,18
2015,Noviembre,11,11/1/2015,Kenia,4,7,0,11
2015,Noviembre,11,11/1/2015,Kirguistán,2,6,0,8
2015,Noviembre,11,11/1/2015,Kuwait,1,1,0,2
2015,Noviembre,11,11/1/2015,República de Kosovo,0,1,0,1
2015,Noviembre,11,11/1/2015,Letonia,10,11,0,21
2015,Noviembre,11,11/1/2015,Lituania,36,23,0,59
2015,Noviembre,11,11/1/2015,Líbano,13,24,0,37
2015,Noviembre,11,11/1/2015,Liechtenstein,1,4,0,5
2015,Noviembre,11,11/1/2015,Luxemburgo,10,14,0,24
2015,Noviembre,11,11/1/2015,Macedonia,0,4,0,4
2015,Noviembre,11,11/1/2015,Madagascar,1,1,0,2
2015,Noviembre,11,11/1/2015,Malasia,29,32,0,61
2015,Noviembre,11,11/1/2015,Malta,2,15,0,17
2015,Noviembre,11,11/1/2015,Marruecos,5,25,0,30
2015,Noviembre,11,11/1/2015,Mauricio,1,3,0,4
2015,Noviembre,11,11/1/2015,Mauritania,0,1,0,1
2015,Noviembre,11,11/1/2015,México,4350,8727,0,13077
2015,Noviembre,11,11/1/2015,República de Moldavia,4,1,0,5
2015,Noviembre,11,11/1/2015,Mongolia,1,1,0,2
2015,Noviembre,11,11/1/2015,Montenegro,0,3,0,3
2015,Noviembre,11,11/1/2015,Mozambique,0,1,0,1
2015,Noviembre,11,11/1/2015,Myanmar,1,1,0,2
2015,Noviembre,11,11/1/2015,Nepal,1,4,0,5
2015,Noviembre,11,11/1/2015,Nicaragua,93,123,0,216
2015,Noviembre,11,11/1/2015,Nigeria,3,10,0,13
2015,Noviembre,11,11/1/2015,Noruega,150,241,0,391
2015,Noviembre,11,11/1/2015,Nueva Zelanda,79,138,0,217
2015,Noviembre,11,11/1/2015,Omán,0,3,0,3
2015,Noviembre,11,11/1/2015,Pakistán,4,19,0,23
2015,Noviembre,11,11/1/2015,Panamá,3574,3821,0,7395
2015,Noviembre,11,11/1/2015,Paraguay,372,445,0,817
2015,Noviembre,11,11/1/2015,Perú,4754,6416,0,11170
2015,Noviembre,11,11/1/2015,Palestina,0,2,0,2
2015,Noviembre,11,11/1/2015,Polonia,228,294,0,522
2015,Noviembre,11,11/1/2015,Portugal,372,680,0,1052
2015,Noviembre,11,11/1/2015,Qatar,0,1,0,1
2015,Noviembre,11,11/1/2015,Reino Unido de Gran Bretaña e Irlanda del Norte,1024,2543,0,3567
2015,Noviembre,11,11/1/2015,Federación de Rusia,186,381,0,567
2015,Noviembre,11,11/1/2015,República Dominicana,688,1031,0,1719
2015,Noviembre,11,11/1/2015,Rumania,68,133,0,201
2015,Noviembre,11,11/1/2015,San Cristóbal y Nevis,0,7,0,7
2015,Noviembre,11,11/1/2015,Samoa Occidental,1,0,0,1
2015,Noviembre,11,11/1/2015,San  Vicente y las Granadinas,1,4,0,5
2015,Noviembre,11,11/1/2015,Santa Lucia,8,6,0,14
2015,Noviembre,11,11/1/2015,Senegal,0,2,0,2
2015,Noviembre,11,11/1/2015,Serbia,8,14,0,22
2015,Noviembre,11,11/1/2015,Sierra Leona,0,2,0,2
2015,Noviembre,11,11/1/2015,Singapur,16,28,0,44
2015,Noviembre,11,11/1/2015,República Árabe Siria,0,2,0,2
2015,Noviembre,11,11/1/2015,Sri Lanka,3,6,0,9
2015,Noviembre,11,11/1/2015,Sudáfrica,44,99,0,143
2015,Noviembre,11,11/1/2015,Sudán,0,1,0,1
2015,Noviembre,11,11/1/2015,Suecia,244,442,0,686
2015,Noviembre,11,11/1/2015,Suiza,435,804,0,1239
2015,Noviembre,11,11/1/2015,Surinam,38,46,0,84
2015,Noviembre,11,11/1/2015,Taiwán,66,111,0,177
2015,Noviembre,11,11/1/2015,República de Tayikistán,1,2,0,3
2015,Noviembre,11,11/1/2015,Tailandia,39,20,0,59
2015,Noviembre,11,11/1/2015,Tanzania,0,3,0,3
2015,Noviembre,11,11/1/2015,Trinidad y Tobago,53,104,0,157
2015,Noviembre,11,11/1/2015,Túnez,2,9,0,11
2015,Noviembre,11,11/1/2015,Turkmenistán,1,0,0,1
2015,Noviembre,11,11/1/2015,Turquía,42,131,0,173
2015,Noviembre,11,11/1/2015,Ucrania,21,52,0,73
2015,Noviembre,11,11/1/2015,Uganda,3,2,0,5
2015,Noviembre,11,11/1/2015,Uruguay,349,671,0,1020
2015,Noviembre,11,11/1/2015,Uzbekistán,1,0,0,1
2015,Noviembre,11,11/1/2015,Venezuela,12214,13777,0,25991
2015,Noviembre,11,11/1/2015,Vietnam,3,3,0,6
2015,Noviembre,11,11/1/2015,Zambia,0,1,0,1
2015,Noviembre,11,11/1/2015,Zimbabue,0,3,0,3
2015,Noviembre,11,11/1/2015,Anguila/Territorio Británico de Ultramar,2,1,0,3
2015,Noviembre,11,11/1/2015,Desconocido,96,189,0,285
2015,Diciembre,12,12/1/2015,Albania,0,3,0,3
2015,Diciembre,12,12/1/2015,Alemania,2298,3480,0,5778
2015,Diciembre,12,12/1/2015,Andorra,2,7,0,9
2015,Diciembre,12,12/1/2015,Angola,0,3,0,3
2015,Diciembre,12,12/1/2015,Antigua y Barbuda,0,7,0,7
2015,Diciembre,12,12/1/2015,Países Bajos,1685,2638,0,4323
2015,Diciembre,12,12/1/2015,Arabia Saudita,2,35,0,37
2015,Diciembre,12,12/1/2015,Argelia,3,5,0,8
2015,Diciembre,12,12/1/2015,Argentina,4579,6314,0,10893
2015,Diciembre,12,12/1/2015,República de Armenia,2,1,0,3
2015,Diciembre,12,12/1/2015,Aruba,0,4,0,4
2015,Diciembre,12,12/1/2015,Australia,769,1223,0,1992
2015,Diciembre,12,12/1/2015,Austria,238,359,0,597
2015,Diciembre,12,12/1/2015,Azerbaiyán,1,3,0,4
2015,Diciembre,12,12/1/2015,Bahamas,1,6,0,7
2015,Diciembre,12,12/1/2015,Bahréin,1,4,0,5
2015,Diciembre,12,12/1/2015,Bangladesh,0,3,0,3
2015,Diciembre,12,12/1/2015,Barbados,6,15,0,21
2015,Diciembre,12,12/1/2015,República de Belarús,4,4,0,8
2015,Diciembre,12,12/1/2015,Bélgica,269,540,0,809
2015,Diciembre,12,12/1/2015,Belice,2,9,0,11
2015,Diciembre,12,12/1/2015,Benín,0,2,0,2
2015,Diciembre,12,12/1/2015,Bermudas/Territorio Británico de Ultramar,1,3,0,4
2015,Diciembre,12,12/1/2015,Bolivia,926,805,0,1731
2015,Diciembre,12,12/1/2015,Bosnia y Herzegovina,1,5,0,6
2015,Diciembre,12,12/1/2015,Botsuana,1,0,0,1
2015,Diciembre,12,12/1/2015,Brasil,6870,6777,0,13647
2015,Diciembre,12,12/1/2015,Bulgaria,27,26,0,53
2015,Diciembre,12,12/1/2015,Islas Caimán/Territorio Británico de Ultramar,2,6,0,8
2015,Diciembre,12,12/1/2015,Camerún,1,0,0,1
2015,Diciembre,12,12/1/2015,Canadá,2463,3439,0,5902
2015,Diciembre,12,12/1/2015,España,3757,6919,0,10676
2015,Diciembre,12,12/1/2015,Comoras,0,1,0,1
2015,Diciembre,12,12/1/2015,República Democrática del Congo,1,0,0,1
2015,Diciembre,12,12/1/2015,República de Corea,353,516,0,869
2015,Diciembre,12,12/1/2015,Costa Rica,1846,2077,0,3923
2015,Diciembre,12,12/1/2015,Croacia,14,59,0,73
2015,Diciembre,12,12/1/2015,Cuba,373,555,0,928
2015,Diciembre,12,12/1/2015,República Checa,75,86,0,161
2015,Diciembre,12,12/1/2015,Chile,3312,4521,0,7833
2015,Diciembre,12,12/1/2015,China,323,707,0,1030
2015,Diciembre,12,12/1/2015,Chipre,2,5,0,7
2015,Diciembre,12,12/1/2015,Dinamarca,172,275,0,447
2015,Diciembre,12,12/1/2015,Dominica,0,2,0,2
2015,Diciembre,12,12/1/2015,Ecuador,6861,9119,0,15980
2015,Diciembre,12,12/1/2015,Egipto,5,19,0,24
2015,Diciembre,12,12/1/2015,El Salvador,1037,1146,0,2183
2015,Diciembre,12,12/1/2015,Emiratos Árabes,2,11,0,13
2015,Diciembre,12,12/1/2015,Eslovaquia,22,35,0,57
2015,Diciembre,12,12/1/2015,Eslovenia,23,36,0,59
2015,Diciembre,12,12/1/2015,Estados Unidos de América,22880,35461,0,58341
2015,Diciembre,12,12/1/2015,Estonia,8,18,0,26
2015,Diciembre,12,12/1/2015,Islas Fiji,1,0,0,1
2015,Diciembre,12,12/1/2015,Filipinas,52,273,0,325
2015,Diciembre,12,12/1/2015,Finlandia,114,164,0,278
2015,Diciembre,12,12/1/2015,Francia,2174,3491,0,5665
2015,Diciembre,12,12/1/2015,Georgia,1,7,0,8
2015,Diciembre,12,12/1/2015,Ghana,0,6,0,6
2015,Diciembre,12,12/1/2015,Granada,1,4,0,5
2015,Diciembre,12,12/1/2015,Grecia,53,111,0,164
2015,Diciembre,12,12/1/2015,Guatemala,921,1174,0,2095
2015,Diciembre,12,12/1/2015,Guyana,6,21,0,27
2015,Diciembre,12,12/1/2015,Guinea,0,1,0,1
2015,Diciembre,12,12/1/2015,Guinea Ecuatorial,2,0,0,2
2015,Diciembre,12,12/1/2015,Guam/Territorio no incorporado de Estados Unidos,1,0,0,1
2015,Diciembre,12,12/1/2015,Haití,10,19,0,29
2015,Diciembre,12,12/1/2015,Honduras,456,436,0,892
2015,Diciembre,12,12/1/2015,Hong Kong,1,0,0,1
2015,Diciembre,12,12/1/2015,Hungría,36,48,0,84
2015,Diciembre,12,12/1/2015,India,104,519,0,623
2015,Diciembre,12,12/1/2015,Indonesia,25,46,0,71
2015,Diciembre,12,12/1/2015,Iraq,0,1,0,1
2015,Diciembre,12,12/1/2015,Irán,6,19,0,25
2015,Diciembre,12,12/1/2015,República de Irlanda,112,249,0,361
2015,Diciembre,12,12/1/2015,Islandia,10,21,0,31
2015,Diciembre,12,12/1/2015,Israel,150,549,0,699
2015,Diciembre,12,12/1/2015,Italia,1141,2682,0,3823
2015,Diciembre,12,12/1/2015,Jamaica,17,34,0,51
2015,Diciembre,12,12/1/2015,Japón,220,502,0,722
2015,Diciembre,12,12/1/2015,Jordania,6,14,0,20
2015,Diciembre,12,12/1/2015,Kazajistán,4,3,0,7
2015,Diciembre,12,12/1/2015,Kenia,5,5,0,10
2015,Diciembre,12,12/1/2015,Kiribati,0,1,0,1
2015,Diciembre,12,12/1/2015,Kuwait,2,12,0,14
2015,Diciembre,12,12/1/2015,República de Kosovo,0,1,0,1
2015,Diciembre,12,12/1/2015,Letonia,10,19,0,29
2015,Diciembre,12,12/1/2015,Lituania,38,35,0,73
2015,Diciembre,12,12/1/2015,Líbano,13,29,0,42
2015,Diciembre,12,12/1/2015,Liechtenstein,5,8,0,13
2015,Diciembre,12,12/1/2015,Luxemburgo,16,19,0,35
2015,Diciembre,12,12/1/2015,Macedonia,1,3,0,4
2015,Diciembre,12,12/1/2015,Malasia,24,21,0,45
2015,Diciembre,12,12/1/2015,Malta,9,19,0,28
2015,Diciembre,12,12/1/2015,Marruecos,8,21,0,29
2015,Diciembre,12,12/1/2015,Mauricio,1,2,0,3
2015,Diciembre,12,12/1/2015,México,5284,7929,0,13213
2015,Diciembre,12,12/1/2015,República de Moldavia,2,0,0,2
2015,Diciembre,12,12/1/2015,Mongolia,1,1,0,2
2015,Diciembre,12,12/1/2015,Montenegro,2,5,0,7
2015,Diciembre,12,12/1/2015,Mozambique,2,2,0,4
2015,Diciembre,12,12/1/2015,Myanmar,3,19,0,22
2015,Diciembre,12,12/1/2015,Namibia,0,1,0,1
2015,Diciembre,12,12/1/2015,Nepal,3,2,0,5
2015,Diciembre,12,12/1/2015,Nicaragua,120,94,0,214
2015,Diciembre,12,12/1/2015,Nigeria,2,4,0,6
2015,Diciembre,12,12/1/2015,Noruega,214,277,0,491
2015,Diciembre,12,12/1/2015,Nueva Zelanda,116,179,0,295
2015,Diciembre,12,12/1/2015,Omán,0,6,0,6
2015,Diciembre,12,12/1/2015,Pakistán,2,12,0,14
2015,Diciembre,12,12/1/2015,Panamá,2751,3543,0,6294
2015,Diciembre,12,12/1/2015,Paraguay,248,194,0,442
2015,Diciembre,12,12/1/2015,Perú,4528,5707,0,10235
2015,Diciembre,12,12/1/2015,Palestina,0,1,0,1
2015,Diciembre,12,12/1/2015,Polonia,146,195,0,341
2015,Diciembre,12,12/1/2015,Portugal,295,551,0,846
2015,Diciembre,12,12/1/2015,Puerto Rico/Territorio de Estados Unidos,0,1,0,1
2015,Diciembre,12,12/1/2015,Qatar,0,1,0,1
2015,Diciembre,12,12/1/2015,Reino Unido de Gran Bretaña e Irlanda del Norte,1639,3149,0,4788
2015,Diciembre,12,12/1/2015,Federación de Rusia,206,249,0,455
2015,Diciembre,12,12/1/2015,República Dominicana,577,809,0,1386
2015,Diciembre,12,12/1/2015,Rumania,69,86,0,155
2015,Diciembre,12,12/1/2015,Rwanda,0,1,0,1
2015,Diciembre,12,12/1/2015,San Cristóbal y Nevis,2,5,0,7
2015,Diciembre,12,12/1/2015,San Marino,1,7,0,8
2015,Diciembre,12,12/1/2015,San  Vicente y las Granadinas,2,3,0,5
2015,Diciembre,12,12/1/2015,Santa Lucia,4,3,0,7
2015,Diciembre,12,12/1/2015,Santa Sede/Ciudad del Vaticano,0,1,0,1
2015,Diciembre,12,12/1/2015,Senegal,1,0,0,1
2015,Diciembre,12,12/1/2015,Serbia,20,13,0,33
2015,Diciembre,12,12/1/2015,Singapur,38,53,0,91
2015,Diciembre,12,12/1/2015,República Árabe Siria,0,2,0,2
2015,Diciembre,12,12/1/2015,Somalia,0,1,0,1
2015,Diciembre,12,12/1/2015,Sri Lanka,3,1,0,4
2015,Diciembre,12,12/1/2015,Sudáfrica,46,83,0,129
2015,Diciembre,12,12/1/2015,Sudán,0,2,0,2
2015,Diciembre,12,12/1/2015,Suecia,543,771,0,1314
2015,Diciembre,12,12/1/2015,Suiza,711,1264,0,1975
2015,Diciembre,12,12/1/2015,Surinam,6,12,0,18
2015,Diciembre,12,12/1/2015,Taiwán,64,59,0,123
2015,Diciembre,12,12/1/2015,Tailandia,41,17,0,58
2015,Diciembre,12,12/1/2015,Togo,0,2,0,2
2015,Diciembre,12,12/1/2015,Trinidad y Tobago,36,98,0,134
2015,Diciembre,12,12/1/2015,Túnez,2,8,0,10
2015,Diciembre,12,12/1/2015,Turquía,53,144,0,197
2015,Diciembre,12,12/1/2015,Ucrania,38,35,0,73
2015,Diciembre,12,12/1/2015,Uganda,1,2,0,3
2015,Diciembre,12,12/1/2015,Uruguay,247,443,0,690
2015,Diciembre,12,12/1/2015,Uzbekistán,3,2,0,5
2015,Diciembre,12,12/1/2015,Venezuela,13310,13736,0,27046
2015,Diciembre,12,12/1/2015,Vietnam,6,2,0,8
2015,Diciembre,12,12/1/2015,República Árabe de Yemen,0,1,0,1
2015,Diciembre,12,12/1/2015,Zambia,0,1,0,1
2015,Diciembre,12,12/1/2015,Zimbabue,0,2,0,2
2015,Diciembre,12,12/1/2015,Desconocido,33,90,0,123
2016,Enero,1,1/1/2016,Albania,3,5,0,8
2016,Enero,1,1/1/2016,Alemania,2196,3282,0,5478
2016,Enero,1,1/1/2016,Andorra,3,10,0,13
2016,Enero,1,1/1/2016,Antigua y Barbuda,1,10,0,11
2016,Enero,1,1/1/2016,Países Bajos,1418,2238,0,3656
2016,Enero,1,1/1/2016,Arabia Saudita,2,9,0,11
2016,Enero,1,1/1/2016,Argelia,3,3,0,6
2016,Enero,1,1/1/2016,Argentina,8324,8375,0,16699
2016,Enero,1,1/1/2016,República de Armenia,2,0,0,2
2016,Enero,1,1/1/2016,Aruba,2,0,0,2
2016,Enero,1,1/1/2016,Australia,639,1006,0,1645
2016,Enero,1,1/1/2016,Austria,199,358,0,557
2016,Enero,1,1/1/2016,Azerbaiyán,2,2,0,4
2016,Enero,1,1/1/2016,Bahamas,9,12,0,21
2016,Enero,1,1/1/2016,Bahréin,0,1,0,1
2016,Enero,1,1/1/2016,Bangladesh,0,3,0,3
2016,Enero,1,1/1/2016,Barbados,13,14,0,27
2016,Enero,1,1/1/2016,República de Belarús,3,11,0,14
2016,Enero,1,1/1/2016,Bélgica,259,529,0,788
2016,Enero,1,1/1/2016,Belice,4,11,0,15
2016,Enero,1,1/1/2016,Benín,1,0,0,1
2016,Enero,1,1/1/2016,Bermudas/Territorio Británico de Ultramar,0,4,0,4
2016,Enero,1,1/1/2016,Bolivia,862,956,0,1818
2016,Enero,1,1/1/2016,Bosnia y Herzegovina,1,2,0,3
2016,Enero,1,1/1/2016,Brasil,8946,8877,0,17823
2016,Enero,1,1/1/2016,Bulgaria,38,52,0,90
2016,Enero,1,1/1/2016,Burkina Faso,0,2,0,2
2016,Enero,1,1/1/2016,Cabo Verde,1,1,0,2
2016,Enero,1,1/1/2016,Islas Caimán/Territorio Británico de Ultramar,2,4,0,6
2016,Enero,1,1/1/2016,Camerún,2,2,0,4
2016,Enero,1,1/1/2016,Canadá,2344,3283,0,5627
2016,Enero,1,1/1/2016,España,3188,6732,0,9920
2016,Enero,1,1/1/2016,República Del Congo,0,2,0,2
2016,Enero,1,1/1/2016,República Democrática del Congo,1,4,0,5
2016,Enero,1,1/1/2016,República de Corea,494,688,0,1182
2016,Enero,1,1/1/2016,Costa de Marfil,0,3,0,3
2016,Enero,1,1/1/2016,Costa Rica,1455,1644,0,3099
2016,Enero,1,1/1/2016,Croacia,19,71,0,90
2016,Enero,1,1/1/2016,Cuba,231,377,0,608
2016,Enero,1,1/1/2016,República Checa,69,94,0,163
2016,Enero,1,1/1/2016,Chile,4429,5278,0,9707
2016,Enero,1,1/1/2016,China,397,826,0,1223
2016,Enero,1,1/1/2016,Chipre,2,6,0,8
2016,Enero,1,1/1/2016,Dinamarca,190,304,0,494
2016,Enero,1,1/1/2016,Dominica,1,6,0,7
2016,Enero,1,1/1/2016,Ecuador,4475,6682,0,11157
2016,Enero,1,1/1/2016,Egipto,11,33,0,44
2016,Enero,1,1/1/2016,El Salvador,848,1093,0,1941
2016,Enero,1,1/1/2016,Emiratos Árabes,1,3,0,4
2016,Enero,1,1/1/2016,Eslovaquia,31,59,0,90
2016,Enero,1,1/1/2016,Eslovenia,41,49,0,90
2016,Enero,1,1/1/2016,Estados Unidos de América,13390,23665,0,37055
2016,Enero,1,1/1/2016,Estonia,11,19,0,30
2016,Enero,1,1/1/2016,Etiopia,0,2,0,2
2016,Enero,1,1/1/2016,Filipinas,43,228,0,271
2016,Enero,1,1/1/2016,Finlandia,80,115,0,195
2016,Enero,1,1/1/2016,Francia,2485,3628,0,6113
2016,Enero,1,1/1/2016,Georgia,2,10,0,12
2016,Enero,1,1/1/2016,Ghana,1,6,0,7
2016,Enero,1,1/1/2016,Granada,2,7,0,9
2016,Enero,1,1/1/2016,Grecia,41,112,0,153
2016,Enero,1,1/1/2016,Guatemala,521,889,0,1410
2016,Enero,1,1/1/2016,Guyana,12,20,0,32
2016,Enero,1,1/1/2016,Guinea Ecuatorial,0,4,0,4
2016,Enero,1,1/1/2016,Haití,15,30,0,45
2016,Enero,1,1/1/2016,Honduras,320,381,0,701
2016,Enero,1,1/1/2016,Hungría,51,66,0,117
2016,Enero,1,1/1/2016,India,93,545,0,638
2016,Enero,1,1/1/2016,Indonesia,11,28,0,39
2016,Enero,1,1/1/2016,Iraq,0,2,0,2
2016,Enero,1,1/1/2016,Irán,6,13,0,19
2016,Enero,1,1/1/2016,República de Irlanda,125,256,0,381
2016,Enero,1,1/1/2016,Islandia,16,21,0,37
2016,Enero,1,1/1/2016,Israel,192,705,0,897
2016,Enero,1,1/1/2016,Italia,1314,2957,0,4271
2016,Enero,1,1/1/2016,Jamaica,39,44,0,83
2016,Enero,1,1/1/2016,Islas Salomón,1,0,0,1
2016,Enero,1,1/1/2016,Japón,227,559,0,786
2016,Enero,1,1/1/2016,Jordania,3,8,0,11
2016,Enero,1,1/1/2016,Kazajistán,7,7,0,14
2016,Enero,1,1/1/2016,Kenia,7,9,0,16
2016,Enero,1,1/1/2016,Kuwait,3,5,0,8
2016,Enero,1,1/1/2016,República de Kosovo,0,3,0,3
2016,Enero,1,1/1/2016,República Democrática Popular  Lao,0,1,0,1
2016,Enero,1,1/1/2016,Letonia,15,31,0,46
2016,Enero,1,1/1/2016,Lituania,39,32,0,71
2016,Enero,1,1/1/2016,Líbano,18,24,0,42
2016,Enero,1,1/1/2016,Libia,0,1,0,1
2016,Enero,1,1/1/2016,Liechtenstein,2,5,0,7
2016,Enero,1,1/1/2016,Luxemburgo,10,13,0,23
2016,Enero,1,1/1/2016,Macedonia,2,3,0,5
2016,Enero,1,1/1/2016,Madagascar,1,1,0,2
2016,Enero,1,1/1/2016,Malasia,24,35,0,59
2016,Enero,1,1/1/2016,Malawi,1,0,0,1
2016,Enero,1,1/1/2016,Malí,1,2,0,3
2016,Enero,1,1/1/2016,Malta,12,14,0,26
2016,Enero,1,1/1/2016,Marruecos,12,23,0,35
2016,Enero,1,1/1/2016,Mauricio,0,2,0,2
2016,Enero,1,1/1/2016,México,4500,7473,0,11973
2016,Enero,1,1/1/2016,República de Moldavia,3,0,0,3
2016,Enero,1,1/1/2016,Mónaco,1,1,0,2
2016,Enero,1,1/1/2016,Mongolia,0,1,0,1
2016,Enero,1,1/1/2016,Montenegro,0,2,0,2
2016,Enero,1,1/1/2016,Mozambique,1,1,0,2
2016,Enero,1,1/1/2016,Myanmar,0,4,0,4
2016,Enero,1,1/1/2016,Nepal,2,4,0,6
2016,Enero,1,1/1/2016,Nicaragua,111,109,0,220
2016,Enero,1,1/1/2016,Nigeria,5,18,0,23
2016,Enero,1,1/1/2016,Noruega,172,240,0,412
2016,Enero,1,1/1/2016,Nueva Zelanda,82,151,0,233
2016,Enero,1,1/1/2016,Omán,0,1,0,1
2016,Enero,1,1/1/2016,Pakistán,8,15,0,23
2016,Enero,1,1/1/2016,Panamá,2869,3060,0,5929
2016,Enero,1,1/1/2016,Paraguay,357,321,0,678
2016,Enero,1,1/1/2016,Perú,4980,6146,0,11126
2016,Enero,1,1/1/2016,Palestina,1,1,0,2
2016,Enero,1,1/1/2016,Polonia,192,322,0,514
2016,Enero,1,1/1/2016,Portugal,419,774,0,1193
2016,Enero,1,1/1/2016,Qatar,0,3,0,3
2016,Enero,1,1/1/2016,Reino Unido de Gran Bretaña e Irlanda del Norte,2142,3368,0,5510
2016,Enero,1,1/1/2016,República CentroÁfricana,5,0,0,5
2016,Enero,1,1/1/2016,Federación de Rusia,318,429,0,747
2016,Enero,1,1/1/2016,República Dominicana,495,716,0,1211
2016,Enero,1,1/1/2016,Rumania,70,113,0,183
2016,Enero,1,1/1/2016,San Cristóbal y Nevis,2,4,0,6
2016,Enero,1,1/1/2016,San  Vicente y las Granadinas,0,4,0,4
2016,Enero,1,1/1/2016,Santa Lucia,6,3,0,9
2016,Enero,1,1/1/2016,Santa Sede/Ciudad del Vaticano,0,2,0,2
2016,Enero,1,1/1/2016,Senegal,1,1,0,2
2016,Enero,1,1/1/2016,Serbia,21,37,0,58
2016,Enero,1,1/1/2016,Sierra Leona,0,2,0,2
2016,Enero,1,1/1/2016,Singapur,22,39,0,61
2016,Enero,1,1/1/2016,República Árabe Siria,0,3,0,3
2016,Enero,1,1/1/2016,Sri Lanka,2,3,0,5
2016,Enero,1,1/1/2016,Sudáfrica,59,95,0,154
2016,Enero,1,1/1/2016,Suecia,341,522,0,863
2016,Enero,1,1/1/2016,Suiza,680,1024,0,1704
2016,Enero,1,1/1/2016,Surinam,14,25,0,39
2016,Enero,1,1/1/2016,Taiwán,65,96,0,161
2016,Enero,1,1/1/2016,Tailandia,9,6,0,15
2016,Enero,1,1/1/2016,Tanzania,0,2,0,2
2016,Enero,1,1/1/2016,Trinidad y Tobago,27,77,0,104
2016,Enero,1,1/1/2016,Túnez,1,11,0,12
2016,Enero,1,1/1/2016,Turquía,50,180,0,230
2016,Enero,1,1/1/2016,Ucrania,37,59,0,96
2016,Enero,1,1/1/2016,Uganda,1,2,0,3
2016,Enero,1,1/1/2016,Uruguay,393,535,0,928
2016,Enero,1,1/1/2016,Venezuela,10712,12115,0,22827
2016,Enero,1,1/1/2016,Vietnam,1,8,0,9
2016,Enero,1,1/1/2016,República Árabe de Yemen,0,1,0,1
2016,Enero,1,1/1/2016,Zambia,1,1,0,2
2016,Enero,1,1/1/2016,Zimbabue,2,6,0,8
2016,Enero,1,1/1/2016,Anguila/Territorio Británico de Ultramar,0,1,0,1
2016,Enero,1,1/1/2016,Desconocido,43,103,0,146
2016,Febrero,2,2/1/2016,Afganistán,0,1,0,1
2016,Febrero,2,2/1/2016,Albania,3,2,0,5
2016,Febrero,2,2/1/2016,Alemania,2392,3458,0,5850
2016,Febrero,2,2/1/2016,Andorra,3,12,0,15
2016,Febrero,2,2/1/2016,Angola,0,1,0,1
2016,Febrero,2,2/1/2016,Antigua y Barbuda,4,8,0,12
2016,Febrero,2,2/1/2016,Países Bajos,1388,2156,0,3544
2016,Febrero,2,2/1/2016,Arabia Saudita,0,8,0,8
2016,Febrero,2,2/1/2016,Argelia,3,4,0,7
2016,Febrero,2,2/1/2016,Argentina,6185,7317,0,13502
2016,Febrero,2,2/1/2016,República de Armenia,2,8,0,10
2016,Febrero,2,2/1/2016,Aruba,1,2,0,3
2016,Febrero,2,2/1/2016,Australia,407,731,0,1138
2016,Febrero,2,2/1/2016,Austria,296,430,0,726
2016,Febrero,2,2/1/2016,Azerbaiyán,1,3,0,4
2016,Febrero,2,2/1/2016,Bahamas,6,6,0,12
2016,Febrero,2,2/1/2016,Bahréin,1,2,0,3
2016,Febrero,2,2/1/2016,Bangladesh,1,2,0,3
2016,Febrero,2,2/1/2016,Barbados,12,14,0,26
2016,Febrero,2,2/1/2016,República de Belarús,29,80,0,109
2016,Febrero,2,2/1/2016,Bélgica,256,515,0,771
2016,Febrero,2,2/1/2016,Belice,5,15,0,20
2016,Febrero,2,2/1/2016,Bermudas/Territorio Británico de Ultramar,1,3,0,4
2016,Febrero,2,2/1/2016,Bolivia,627,729,0,1356
2016,Febrero,2,2/1/2016,Bosnia y Herzegovina,1,0,0,1
2016,Febrero,2,2/1/2016,Brasil,8964,9161,0,18125
2016,Febrero,2,2/1/2016,Bulgaria,50,51,0,101
2016,Febrero,2,2/1/2016,Cabo Verde,2,2,0,4
2016,Febrero,2,2/1/2016,Islas Caimán/Territorio Británico de Ultramar,5,1,0,6
2016,Febrero,2,2/1/2016,Camerún,0,5,0,5
2016,Febrero,2,2/1/2016,Canadá,2261,3054,0,5315
2016,Febrero,2,2/1/2016,España,2734,6340,0,9074
2016,Febrero,2,2/1/2016,República Democrática del Congo,2,2,0,4
2016,Febrero,2,2/1/2016,República de Corea,292,506,0,798
2016,Febrero,2,2/1/2016,Costa de Marfil,0,7,0,7
2016,Febrero,2,2/1/2016,Costa Rica,885,1300,0,2185
2016,Febrero,2,2/1/2016,Croacia,26,60,0,86
2016,Febrero,2,2/1/2016,Cuba,146,265,0,411
2016,Febrero,2,2/1/2016,República Checa,62,127,0,189
2016,Febrero,2,2/1/2016,Chile,6386,6492,0,12878
2016,Febrero,2,2/1/2016,China,354,701,0,1055
2016,Febrero,2,2/1/2016,Chipre,6,4,0,10
2016,Febrero,2,2/1/2016,Dinamarca,210,326,0,536
2016,Febrero,2,2/1/2016,Dominica,0,7,0,7
2016,Febrero,2,2/1/2016,Ecuador,5652,7451,0,13103
2016,Febrero,2,2/1/2016,Egipto,5,35,0,40
2016,Febrero,2,2/1/2016,El Salvador,778,1095,0,1873
2016,Febrero,2,2/1/2016,Emiratos Árabes,5,67,0,72
2016,Febrero,2,2/1/2016,Eslovaquia,26,32,0,58
2016,Febrero,2,2/1/2016,Eslovenia,33,39,0,72
2016,Febrero,2,2/1/2016,Estados Unidos de América,14717,25947,0,40664
2016,Febrero,2,2/1/2016,Estonia,8,13,0,21
2016,Febrero,2,2/1/2016,Etiopia,1,1,0,2
2016,Febrero,2,2/1/2016,Islas Fiji,0,1,0,1
2016,Febrero,2,2/1/2016,Filipinas,128,344,0,472
2016,Febrero,2,2/1/2016,Finlandia,65,93,0,158
2016,Febrero,2,2/1/2016,Francia,2426,3597,0,6023
2016,Febrero,2,2/1/2016,Gabón,0,1,0,1
2016,Febrero,2,2/1/2016,Georgia,2,20,0,22
2016,Febrero,2,2/1/2016,Ghana,1,14,0,15
2016,Febrero,2,2/1/2016,Granada,2,2,0,4
2016,Febrero,2,2/1/2016,Grecia,30,115,0,145
2016,Febrero,2,2/1/2016,Guatemala,484,992,0,1476
2016,Febrero,2,2/1/2016,Guyana,11,7,0,18
2016,Febrero,2,2/1/2016,Haití,3,16,0,19
2016,Febrero,2,2/1/2016,Honduras,283,384,0,667
2016,Febrero,2,2/1/2016,Hong Kong,0,1,0,1
2016,Febrero,2,2/1/2016,Hungría,43,55,0,98
2016,Febrero,2,2/1/2016,India,74,483,0,557
2016,Febrero,2,2/1/2016,Indonesia,13,24,0,37
2016,Febrero,2,2/1/2016,Iraq,0,2,0,2
2016,Febrero,2,2/1/2016,Irán,5,12,0,17
2016,Febrero,2,2/1/2016,República de Irlanda,118,264,0,382
2016,Febrero,2,2/1/2016,Islandia,12,16,0,28
2016,Febrero,2,2/1/2016,Israel,207,703,0,910
2016,Febrero,2,2/1/2016,Italia,1059,2566,0,3625
2016,Febrero,2,2/1/2016,Jamaica,31,43,0,74
2016,Febrero,2,2/1/2016,Japón,320,662,0,982
2016,Febrero,2,2/1/2016,Jordania,1,5,0,6
2016,Febrero,2,2/1/2016,Kazajistán,9,3,0,12
2016,Febrero,2,2/1/2016,Kenia,8,18,0,26
2016,Febrero,2,2/1/2016,Kiribati,0,1,0,1
2016,Febrero,2,2/1/2016,Kuwait,2,5,0,7
2016,Febrero,2,2/1/2016,República de Kosovo,3,2,0,5
2016,Febrero,2,2/1/2016,Letonia,14,30,0,44
2016,Febrero,2,2/1/2016,Lituania,34,35,0,69
2016,Febrero,2,2/1/2016,Líbano,16,13,0,29
2016,Febrero,2,2/1/2016,Liechtenstein,1,2,0,3
2016,Febrero,2,2/1/2016,Luxemburgo,10,12,0,22
2016,Febrero,2,2/1/2016,Macedonia,1,2,0,3
2016,Febrero,2,2/1/2016,Madagascar,3,0,0,3
2016,Febrero,2,2/1/2016,Malasia,33,25,0,58
2016,Febrero,2,2/1/2016,Malí,0,2,0,2
2016,Febrero,2,2/1/2016,Malta,9,23,0,32
2016,Febrero,2,2/1/2016,Marruecos,9,12,0,21
2016,Febrero,2,2/1/2016,Mauricio,0,3,0,3
2016,Febrero,2,2/1/2016,México,3523,7178,0,10701
2016,Febrero,2,2/1/2016,República de Moldavia,2,5,0,7
2016,Febrero,2,2/1/2016,Mónaco,4,0,0,4
2016,Febrero,2,2/1/2016,Mongolia,2,0,0,2
2016,Febrero,2,2/1/2016,Montenegro,1,2,0,3
2016,Febrero,2,2/1/2016,Mozambique,2,0,0,2
2016,Febrero,2,2/1/2016,Myanmar,1,9,0,10
2016,Febrero,2,2/1/2016,Nepal,1,3,0,4
2016,Febrero,2,2/1/2016,Nicaragua,115,115,0,230
2016,Febrero,2,2/1/2016,Nigeria,6,7,0,13
2016,Febrero,2,2/1/2016,Noruega,135,221,0,356
2016,Febrero,2,2/1/2016,Nueva Zelanda,67,132,0,199
2016,Febrero,2,2/1/2016,Omán,0,3,0,3
2016,Febrero,2,2/1/2016,Pakistán,4,20,0,24
2016,Febrero,2,2/1/2016,Panamá,4724,4333,0,9057
2016,Febrero,2,2/1/2016,Paraguay,377,317,0,694
2016,Febrero,2,2/1/2016,Perú,6103,6902,0,13005
2016,Febrero,2,2/1/2016,Palestina,0,5,0,5
2016,Febrero,2,2/1/2016,Polonia,230,333,0,563
2016,Febrero,2,2/1/2016,Portugal,276,654,0,930
2016,Febrero,2,2/1/2016,Reino Unido de Gran Bretaña e Irlanda del Norte,1391,2628,0,4019
2016,Febrero,2,2/1/2016,República CentroÁfricana,0,1,0,1
2016,Febrero,2,2/1/2016,Federación de Rusia,203,278,0,481
2016,Febrero,2,2/1/2016,República Dominicana,495,712,0,1207
2016,Febrero,2,2/1/2016,Rumania,61,99,0,160
2016,Febrero,2,2/1/2016,Rwanda,1,1,0,2
2016,Febrero,2,2/1/2016,San Cristóbal y Nevis,0,2,0,2
2016,Febrero,2,2/1/2016,San Marino,1,2,0,3
2016,Febrero,2,2/1/2016,San  Vicente y las Granadinas,0,1,0,1
2016,Febrero,2,2/1/2016,Santa Lucia,1,5,0,6
2016,Febrero,2,2/1/2016,Santa Sede/Ciudad del Vaticano,0,1,0,1
2016,Febrero,2,2/1/2016,Senegal,0,3,0,3
2016,Febrero,2,2/1/2016,Serbia,10,23,0,33
2016,Febrero,2,2/1/2016,Sierra Leona,2,0,0,2
2016,Febrero,2,2/1/2016,Singapur,13,21,0,34
2016,Febrero,2,2/1/2016,República Árabe Siria,0,2,0,2
2016,Febrero,2,2/1/2016,Sri Lanka,4,2,0,6
2016,Febrero,2,2/1/2016,Sudáfrica,44,150,0,194
2016,Febrero,2,2/1/2016,Sudán,0,2,0,2
2016,Febrero,2,2/1/2016,Suecia,297,432,0,729
2016,Febrero,2,2/1/2016,Suiza,660,985,0,1645
2016,Febrero,2,2/1/2016,Surinam,22,37,0,59
2016,Febrero,2,2/1/2016,Taiwán,73,80,0,153
2016,Febrero,2,2/1/2016,República de Tayikistán,0,2,0,2
2016,Febrero,2,2/1/2016,Tailandia,18,6,0,24
2016,Febrero,2,2/1/2016,Tanzania,2,0,0,2
2016,Febrero,2,2/1/2016,Togo,1,2,0,3
2016,Febrero,2,2/1/2016,Trinidad y Tobago,24,75,0,99
2016,Febrero,2,2/1/2016,Túnez,2,5,0,7
2016,Febrero,2,2/1/2016,Turquía,47,162,0,209
2016,Febrero,2,2/1/2016,Ucrania,26,72,0,98
2016,Febrero,2,2/1/2016,Uganda,2,3,0,5
2016,Febrero,2,2/1/2016,Uruguay,295,497,0,792
2016,Febrero,2,2/1/2016,Uzbekistán,1,2,0,3
2016,Febrero,2,2/1/2016,Venezuela,7632,9835,0,17467
2016,Febrero,2,2/1/2016,Vietnam,4,2,0,6
2016,Febrero,2,2/1/2016,República Árabe de Yemen,0,1,0,1
2016,Febrero,2,2/1/2016,Zambia,1,2,0,3
2016,Febrero,2,2/1/2016,Zimbabue,0,1,0,1
2016,Febrero,2,2/1/2016,Anguila/Territorio Británico de Ultramar,0,1,0,1
2016,Febrero,2,2/1/2016,Desconocido,52,121,0,173
2016,Marzo,3,3/1/2016,Albania,3,4,0,7
2016,Marzo,3,3/1/2016,Alemania,2488,3520,0,6008
2016,Marzo,3,3/1/2016,Andorra,2,15,0,17
2016,Marzo,3,3/1/2016,Antigua y Barbuda,3,10,0,13
2016,Marzo,3,3/1/2016,Países Bajos,1441,2061,0,3502
2016,Marzo,3,3/1/2016,Arabia Saudita,0,25,0,25
2016,Marzo,3,3/1/2016,Argelia,3,6,0,9
2016,Marzo,3,3/1/2016,Argentina,6035,7326,0,13361
2016,Marzo,3,3/1/2016,República de Armenia,3,1,0,4
2016,Marzo,3,3/1/2016,Aruba,1,2,0,3
2016,Marzo,3,3/1/2016,Australia,397,641,0,1038
2016,Marzo,3,3/1/2016,Austria,207,443,0,650
2016,Marzo,3,3/1/2016,Azerbaiyán,2,9,0,11
2016,Marzo,3,3/1/2016,Bahamas,6,7,0,13
2016,Marzo,3,3/1/2016,Bangladesh,0,9,0,9
2016,Marzo,3,3/1/2016,Barbados,14,27,0,41
2016,Marzo,3,3/1/2016,República de Belarús,5,7,0,12
2016,Marzo,3,3/1/2016,Bélgica,267,468,0,735
2016,Marzo,3,3/1/2016,Belice,2,12,0,14
2016,Marzo,3,3/1/2016,Bermudas/Territorio Británico de Ultramar,4,8,0,12
2016,Marzo,3,3/1/2016,Bolivia,647,723,0,1370
2016,Marzo,3,3/1/2016,Bosnia y Herzegovina,0,4,0,4
2016,Marzo,3,3/1/2016,Botsuana,0,2,0,2
2016,Marzo,3,3/1/2016,Brasil,7462,7615,0,15077
2016,Marzo,3,3/1/2016,Brunei Darussalam,0,1,0,1
2016,Marzo,3,3/1/2016,Bulgaria,26,49,0,75
2016,Marzo,3,3/1/2016,Burkina Faso,0,1,0,1
2016,Marzo,3,3/1/2016,Bután,0,2,0,2
2016,Marzo,3,3/1/2016,Cabo Verde,0,3,0,3
2016,Marzo,3,3/1/2016,Islas Caimán/Territorio Británico de Ultramar,2,5,0,7
2016,Marzo,3,3/1/2016,Camerún,1,4,0,5
2016,Marzo,3,3/1/2016,Canadá,2065,2812,0,4877
2016,Marzo,3,3/1/2016,España,3315,6719,0,10034
2016,Marzo,3,3/1/2016,República Democrática del Congo,1,5,0,6
2016,Marzo,3,3/1/2016,República de Corea,268,531,0,799
2016,Marzo,3,3/1/2016,Costa de Marfil,1,2,0,3
2016,Marzo,3,3/1/2016,Costa Rica,1252,1737,0,2989
2016,Marzo,3,3/1/2016,Croacia,19,36,0,55
2016,Marzo,3,3/1/2016,Cuba,165,303,0,468
2016,Marzo,3,3/1/2016,República Checa,59,104,0,163
2016,Marzo,3,3/1/2016,Chile,4180,5317,0,9497
2016,Marzo,3,3/1/2016,China,421,953,0,1374
2016,Marzo,3,3/1/2016,Chipre,6,15,0,21
2016,Marzo,3,3/1/2016,Dinamarca,175,310,0,485
2016,Marzo,3,3/1/2016,Dominica,4,5,0,9
2016,Marzo,3,3/1/2016,Ecuador,6944,9635,0,16579
2016,Marzo,3,3/1/2016,Egipto,2,14,0,16
2016,Marzo,3,3/1/2016,El Salvador,1225,1351,0,2576
2016,Marzo,3,3/1/2016,Emiratos Árabes,1,16,0,17
2016,Marzo,3,3/1/2016,Eslovaquia,28,31,0,59
2016,Marzo,3,3/1/2016,Eslovenia,29,56,0,85
2016,Marzo,3,3/1/2016,Estados Unidos de América,17133,27757,0,44890
2016,Marzo,3,3/1/2016,Estonia,12,8,0,20
2016,Marzo,3,3/1/2016,Etiopia,1,5,0,6
2016,Marzo,3,3/1/2016,Islas Fiji,0,1,0,1
2016,Marzo,3,3/1/2016,Filipinas,40,278,0,318
2016,Marzo,3,3/1/2016,Finlandia,78,129,0,207
2016,Marzo,3,3/1/2016,Francia,1807,2920,0,4727
2016,Marzo,3,3/1/2016,Gambia,1,0,0,1
2016,Marzo,3,3/1/2016,Georgia,2,2,0,4
2016,Marzo,3,3/1/2016,Ghana,1,11,0,12
2016,Marzo,3,3/1/2016,Granada,1,5,0,6
2016,Marzo,3,3/1/2016,Grecia,40,114,0,154
2016,Marzo,3,3/1/2016,Guatemala,870,1191,0,2061
2016,Marzo,3,3/1/2016,Guyana,7,13,0,20
2016,Marzo,3,3/1/2016,Guinea,1,0,0,1
2016,Marzo,3,3/1/2016,Guinea Ecuatorial,0,1,0,1
2016,Marzo,3,3/1/2016,Haití,31,41,0,72
2016,Marzo,3,3/1/2016,Honduras,495,530,0,1025
2016,Marzo,3,3/1/2016,Hong Kong,4,2,0,6
2016,Marzo,3,3/1/2016,Hungría,48,58,0,106
2016,Marzo,3,3/1/2016,India,94,446,0,540
2016,Marzo,3,3/1/2016,Indonesia,9,36,0,45
2016,Marzo,3,3/1/2016,Irán,7,16,0,23
2016,Marzo,3,3/1/2016,República de Irlanda,173,252,0,425
2016,Marzo,3,3/1/2016,Islandia,13,25,0,38
2016,Marzo,3,3/1/2016,Israel,314,1043,0,1357
2016,Marzo,3,3/1/2016,Italia,945,2313,0,3258
2016,Marzo,3,3/1/2016,Jamaica,34,47,0,81
2016,Marzo,3,3/1/2016,Japón,246,590,0,836
2016,Marzo,3,3/1/2016,Jordania,3,12,0,15
2016,Marzo,3,3/1/2016,Kazajistán,8,4,0,12
2016,Marzo,3,3/1/2016,Kenia,3,8,0,11
2016,Marzo,3,3/1/2016,Kirguistán,4,3,0,7
2016,Marzo,3,3/1/2016,Kuwait,0,5,0,5
2016,Marzo,3,3/1/2016,República de Kosovo,1,0,0,1
2016,Marzo,3,3/1/2016,Letonia,9,10,0,19
2016,Marzo,3,3/1/2016,Lituania,28,31,0,59
2016,Marzo,3,3/1/2016,Líbano,10,28,0,38
2016,Marzo,3,3/1/2016,Liberia,1,4,0,5
2016,Marzo,3,3/1/2016,Liechtenstein,1,3,0,4
2016,Marzo,3,3/1/2016,Luxemburgo,7,15,0,22
2016,Marzo,3,3/1/2016,Macedonia,1,3,0,4
2016,Marzo,3,3/1/2016,Madagascar,0,1,0,1
2016,Marzo,3,3/1/2016,Malasia,16,29,0,45
2016,Marzo,3,3/1/2016,Malawi,0,1,0,1
2016,Marzo,3,3/1/2016,Malí,2,5,0,7
2016,Marzo,3,3/1/2016,Malta,5,15,0,20
2016,Marzo,3,3/1/2016,Marruecos,5,20,0,25
2016,Marzo,3,3/1/2016,Mauricio,1,7,0,8
2016,Marzo,3,3/1/2016,México,5299,8738,0,14037
2016,Marzo,3,3/1/2016,República de Moldavia,2,1,0,3
2016,Marzo,3,3/1/2016,Mónaco,3,0,0,3
2016,Marzo,3,3/1/2016,Montenegro,1,2,0,3
2016,Marzo,3,3/1/2016,Mozambique,1,3,0,4
2016,Marzo,3,3/1/2016,Namibia,0,1,0,1
2016,Marzo,3,3/1/2016,Nepal,1,4,0,5
2016,Marzo,3,3/1/2016,Nicaragua,129,128,0,257
2016,Marzo,3,3/1/2016,Nigeria,5,17,0,22
2016,Marzo,3,3/1/2016,Noruega,189,266,0,455
2016,Marzo,3,3/1/2016,Nueva Zelanda,81,117,0,198
2016,Marzo,3,3/1/2016,Omán,1,0,0,1
2016,Marzo,3,3/1/2016,Pakistán,12,16,0,28
2016,Marzo,3,3/1/2016,Panamá,3410,3795,0,7205
2016,Marzo,3,3/1/2016,Paraguay,366,300,0,666
2016,Marzo,3,3/1/2016,Perú,5306,6237,0,11543
2016,Marzo,3,3/1/2016,Palestina,0,1,0,1
2016,Marzo,3,3/1/2016,Polonia,187,235,0,422
2016,Marzo,3,3/1/2016,Portugal,327,659,0,986
2016,Marzo,3,3/1/2016,Reino Unido de Gran Bretaña e Irlanda del Norte,1913,3079,0,4992
2016,Marzo,3,3/1/2016,República CentroÁfricana,1,0,0,1
2016,Marzo,3,3/1/2016,Federación de Rusia,199,301,0,500
2016,Marzo,3,3/1/2016,República Dominicana,743,828,0,1571
2016,Marzo,3,3/1/2016,Rumania,55,97,0,152
2016,Marzo,3,3/1/2016,Rwanda,1,0,0,1
2016,Marzo,3,3/1/2016,San Cristóbal y Nevis,1,4,0,5
2016,Marzo,3,3/1/2016,Samoa Occidental,1,0,0,1
2016,Marzo,3,3/1/2016,San  Vicente y las Granadinas,2,7,0,9
2016,Marzo,3,3/1/2016,Santa Lucia,7,5,0,12
2016,Marzo,3,3/1/2016,Santa Sede/Ciudad del Vaticano,0,1,0,1
2016,Marzo,3,3/1/2016,Senegal,1,1,0,2
2016,Marzo,3,3/1/2016,Serbia,13,16,0,29
2016,Marzo,3,3/1/2016,Sierra Leona,0,2,0,2
2016,Marzo,3,3/1/2016,Singapur,13,26,0,39
2016,Marzo,3,3/1/2016,Sri Lanka,2,4,0,6
2016,Marzo,3,3/1/2016,Sudáfrica,67,93,0,160
2016,Marzo,3,3/1/2016,Sudán,1,3,0,4
2016,Marzo,3,3/1/2016,Suecia,313,461,0,774
2016,Marzo,3,3/1/2016,Suiza,552,860,0,1412
2016,Marzo,3,3/1/2016,Surinam,18,23,0,41
2016,Marzo,3,3/1/2016,Taiwán,85,114,0,199
2016,Marzo,3,3/1/2016,República de Tayikistán,0,1,0,1
2016,Marzo,3,3/1/2016,Tailandia,19,12,0,31
2016,Marzo,3,3/1/2016,Tanzania,2,2,0,4
2016,Marzo,3,3/1/2016,Togo,1,3,0,4
2016,Marzo,3,3/1/2016,Trinidad y Tobago,45,87,0,132
2016,Marzo,3,3/1/2016,Túnez,0,4,0,4
2016,Marzo,3,3/1/2016,Turquía,69,190,0,259
2016,Marzo,3,3/1/2016,Ucrania,17,48,0,65
2016,Marzo,3,3/1/2016,Uganda,1,4,0,5
2016,Marzo,3,3/1/2016,Uruguay,427,695,0,1122
2016,Marzo,3,3/1/2016,Uzbekistán,1,0,0,1
2016,Marzo,3,3/1/2016,Venezuela,8643,10149,0,18792
2016,Marzo,3,3/1/2016,Vietnam,8,2,0,10
2016,Marzo,3,3/1/2016,Islas Vírgenes Británicas/Territorio Británico de Ultramar,1,2,0,3
2016,Marzo,3,3/1/2016,Zimbabue,3,3,0,6
2016,Marzo,3,3/1/2016,Desconocido,94,164,0,258
2016,Abril,4,4/1/2016,Afganistán,0,1,0,1
2016,Abril,4,4/1/2016,Albania,0,7,0,7
2016,Abril,4,4/1/2016,Alemania,1397,2408,0,3805
2016,Abril,4,4/1/2016,Andorra,4,7,0,11
2016,Abril,4,4/1/2016,Angola,0,4,0,4
2016,Abril,4,4/1/2016,Antigua y Barbuda,2,11,0,13
2016,Abril,4,4/1/2016,Países Bajos,1673,2349,0,4022
2016,Abril,4,4/1/2016,Arabia Saudita,0,5,0,5
2016,Abril,4,4/1/2016,Argelia,2,2,0,4
2016,Abril,4,4/1/2016,Argentina,5079,6360,0,11439
2016,Abril,4,4/1/2016,República de Armenia,9,3,0,12
2016,Abril,4,4/1/2016,Aruba,2,0,0,2
2016,Abril,4,4/1/2016,Australia,388,708,0,1096
2016,Abril,4,4/1/2016,Austria,116,246,0,362
2016,Abril,4,4/1/2016,Bahamas,4,10,0,14
2016,Abril,4,4/1/2016,Bangladesh,0,5,0,5
2016,Abril,4,4/1/2016,Barbados,9,15,0,24
2016,Abril,4,4/1/2016,República de Belarús,4,1,0,5
2016,Abril,4,4/1/2016,Bélgica,157,353,0,510
2016,Abril,4,4/1/2016,Belice,2,16,0,18
2016,Abril,4,4/1/2016,Benín,2,1,0,3
2016,Abril,4,4/1/2016,Bermudas/Territorio Británico de Ultramar,1,4,0,5
2016,Abril,4,4/1/2016,Bolivia,600,757,0,1357
2016,Abril,4,4/1/2016,Bosnia y Herzegovina,0,5,0,5
2016,Abril,4,4/1/2016,Botsuana,0,4,0,4
2016,Abril,4,4/1/2016,Brasil,8493,8865,0,17358
2016,Abril,4,4/1/2016,Bulgaria,20,42,0,62
2016,Abril,4,4/1/2016,Burundi,1,4,0,5
2016,Abril,4,4/1/2016,Cabo Verde,3,0,0,3
2016,Abril,4,4/1/2016,Islas Caimán/Territorio Británico de Ultramar,4,2,0,6
2016,Abril,4,4/1/2016,Camboya,0,2,0,2
2016,Abril,4,4/1/2016,Camerún,0,1,0,1
2016,Abril,4,4/1/2016,Canadá,1055,1859,0,2914
2016,Abril,4,4/1/2016,Chad,0,1,0,1
2016,Abril,4,4/1/2016,España,2401,5970,0,8371
2016,Abril,4,4/1/2016,República Democrática del Congo,5,2,0,7
2016,Abril,4,4/1/2016,República de Corea,176,452,0,628
2016,Abril,4,4/1/2016,Costa de Marfil,0,2,0,2
2016,Abril,4,4/1/2016,Costa Rica,1054,1475,0,2529
2016,Abril,4,4/1/2016,Croacia,9,45,0,54
2016,Abril,4,4/1/2016,Cuba,211,376,0,587
2016,Abril,4,4/1/2016,República Checa,63,88,0,151
2016,Abril,4,4/1/2016,Chile,3817,4931,0,8748
2016,Abril,4,4/1/2016,China,351,868,0,1219
2016,Abril,4,4/1/2016,Chipre,1,3,0,4
2016,Abril,4,4/1/2016,Dinamarca,118,201,0,319
2016,Abril,4,4/1/2016,Dominica,3,5,0,8
2016,Abril,4,4/1/2016,Ecuador,5776,7418,0,13194
2016,Abril,4,4/1/2016,Egipto,7,38,0,45
2016,Abril,4,4/1/2016,El Salvador,952,1200,0,2152
2016,Abril,4,4/1/2016,Emiratos Árabes,5,13,0,18
2016,Abril,4,4/1/2016,Eritrea,0,2,0,2
2016,Abril,4,4/1/2016,Eslovaquia,21,41,0,62
2016,Abril,4,4/1/2016,Eslovenia,3,30,0,33
2016,Abril,4,4/1/2016,Estados Unidos de América,13079,24162,0,37241
2016,Abril,4,4/1/2016,Estonia,9,8,0,17
2016,Abril,4,4/1/2016,Etiopia,0,4,0,4
2016,Abril,4,4/1/2016,Islas Fiji,0,1,0,1
2016,Abril,4,4/1/2016,Filipinas,42,339,0,381
2016,Abril,4,4/1/2016,Finlandia,60,91,0,151
2016,Abril,4,4/1/2016,Francia,1688,2799,0,4487
2016,Abril,4,4/1/2016,Gabón,0,2,0,2
2016,Abril,4,4/1/2016,Georgia,1,2,0,3
2016,Abril,4,4/1/2016,Ghana,3,10,0,13
2016,Abril,4,4/1/2016,Granada,2,2,0,4
2016,Abril,4,4/1/2016,Grecia,21,56,0,77
2016,Abril,4,4/1/2016,Guatemala,499,1003,0,1502
2016,Abril,4,4/1/2016,Guyana,11,11,0,22
2016,Abril,4,4/1/2016,Guinea,0,1,0,1
2016,Abril,4,4/1/2016,Haití,9,18,0,27
2016,Abril,4,4/1/2016,Honduras,401,506,0,907
2016,Abril,4,4/1/2016,Hong Kong,1,0,0,1
2016,Abril,4,4/1/2016,Hungría,25,38,0,63
2016,Abril,4,4/1/2016,India,75,447,0,522
2016,Abril,4,4/1/2016,Indonesia,17,29,0,46
2016,Abril,4,4/1/2016,Iraq,1,0,0,1
2016,Abril,4,4/1/2016,Irán,6,14,0,20
2016,Abril,4,4/1/2016,República de Irlanda,150,249,0,399
2016,Abril,4,4/1/2016,Islandia,9,7,0,16
2016,Abril,4,4/1/2016,Israel,576,1494,0,2070
2016,Abril,4,4/1/2016,Italia,687,2030,0,2717
2016,Abril,4,4/1/2016,Jamaica,20,31,0,51
2016,Abril,4,4/1/2016,Islas Salomón,0,1,0,1
2016,Abril,4,4/1/2016,Japón,131,458,0,589
2016,Abril,4,4/1/2016,Jordania,2,7,0,9
2016,Abril,4,4/1/2016,Kazajistán,5,3,0,8
2016,Abril,4,4/1/2016,Kenia,14,16,0,30
2016,Abril,4,4/1/2016,República de Kosovo,0,2,0,2
2016,Abril,4,4/1/2016,Lesoto,2,1,0,3
2016,Abril,4,4/1/2016,Letonia,10,9,0,19
2016,Abril,4,4/1/2016,Lituania,21,14,0,35
2016,Abril,4,4/1/2016,Líbano,14,24,0,38
2016,Abril,4,4/1/2016,Liberia,0,1,0,1
2016,Abril,4,4/1/2016,Liechtenstein,1,1,0,2
2016,Abril,4,4/1/2016,Luxemburgo,5,8,0,13
2016,Abril,4,4/1/2016,Macedonia,2,0,0,2
2016,Abril,4,4/1/2016,Madagascar,1,0,0,1
2016,Abril,4,4/1/2016,Malasia,16,26,0,42
2016,Abril,4,4/1/2016,Malí,1,0,0,1
2016,Abril,4,4/1/2016,Malta,5,6,0,11
2016,Abril,4,4/1/2016,Marruecos,10,8,0,18
2016,Abril,4,4/1/2016,Mauricio,0,4,0,4
2016,Abril,4,4/1/2016,Mauritania,0,1,0,1
2016,Abril,4,4/1/2016,México,4037,7904,0,11941
2016,Abril,4,4/1/2016,República de Moldavia,1,2,0,3
2016,Abril,4,4/1/2016,Montenegro,1,1,0,2
2016,Abril,4,4/1/2016,Mozambique,1,3,0,4
2016,Abril,4,4/1/2016,Myanmar,0,4,0,4
2016,Abril,4,4/1/2016,Nepal,2,2,0,4
2016,Abril,4,4/1/2016,Nicaragua,91,134,0,225
2016,Abril,4,4/1/2016,Nigeria,6,13,0,19
2016,Abril,4,4/1/2016,Noruega,78,173,0,251
2016,Abril,4,4/1/2016,Nueva Zelanda,71,140,0,211
2016,Abril,4,4/1/2016,Pakistán,4,13,0,17
2016,Abril,4,4/1/2016,Panamá,3991,3900,0,7891
2016,Abril,4,4/1/2016,Paraguay,345,257,0,602
2016,Abril,4,4/1/2016,Perú,4353,5518,0,9871
2016,Abril,4,4/1/2016,Palestina,1,5,0,6
2016,Abril,4,4/1/2016,Polonia,128,250,0,378
2016,Abril,4,4/1/2016,Portugal,193,521,0,714
2016,Abril,4,4/1/2016,Qatar,0,1,0,1
2016,Abril,4,4/1/2016,Reino Unido de Gran Bretaña e Irlanda del Norte,1225,2329,0,3554
2016,Abril,4,4/1/2016,República CentroÁfricana,1,1,0,2
2016,Abril,4,4/1/2016,Federación de Rusia,161,239,0,400
2016,Abril,4,4/1/2016,República Dominicana,580,699,0,1279
2016,Abril,4,4/1/2016,Rumania,46,88,0,134
2016,Abril,4,4/1/2016,Rwanda,2,1,0,3
2016,Abril,4,4/1/2016,San Cristóbal y Nevis,0,3,0,3
2016,Abril,4,4/1/2016,Samoa Estadounidense/Territorio no incorporado de Estados Unidos,0,1,0,1
2016,Abril,4,4/1/2016,San Marino,0,1,0,1
2016,Abril,4,4/1/2016,San  Vicente y las Granadinas,0,3,0,3
2016,Abril,4,4/1/2016,Santa Lucia,3,5,0,8
2016,Abril,4,4/1/2016,Senegal,2,6,0,8
2016,Abril,4,4/1/2016,Serbia,11,20,0,31
2016,Abril,4,4/1/2016,Sierra Leona,1,4,0,5
2016,Abril,4,4/1/2016,Singapur,16,23,0,39
2016,Abril,4,4/1/2016,República Árabe Siria,0,5,0,5
2016,Abril,4,4/1/2016,Sri Lanka,1,2,0,3
2016,Abril,4,4/1/2016,Sudáfrica,50,103,0,153
2016,Abril,4,4/1/2016,Suecia,243,353,0,596
2016,Abril,4,4/1/2016,Suiza,486,736,0,1222
2016,Abril,4,4/1/2016,Surinam,24,26,0,50
2016,Abril,4,4/1/2016,Taiwán,40,88,0,128
2016,Abril,4,4/1/2016,República de Tayikistán,0,1,0,1
2016,Abril,4,4/1/2016,Tailandia,20,15,0,35
2016,Abril,4,4/1/2016,Tanzania,0,5,0,5
2016,Abril,4,4/1/2016,Togo,0,3,0,3
2016,Abril,4,4/1/2016,Trinidad y Tobago,30,65,0,95
2016,Abril,4,4/1/2016,Túnez,7,9,0,16
2016,Abril,4,4/1/2016,Turquía,33,164,0,197
2016,Abril,4,4/1/2016,Ucrania,18,55,0,73
2016,Abril,4,4/1/2016,Uganda,5,4,0,9
2016,Abril,4,4/1/2016,Uruguay,324,503,0,827
2016,Abril,4,4/1/2016,Uzbekistán,2,0,0,2
2016,Abril,4,4/1/2016,Venezuela,7336,9066,0,16402
2016,Abril,4,4/1/2016,Vietnam,6,20,0,26
2016,Abril,4,4/1/2016,Zambia,2,4,0,6
2016,Abril,4,4/1/2016,Zimbabue,4,2,0,6
2016,Abril,4,4/1/2016,Desconocido,52,121,0,173
2016,Mayo,5,5/1/2016,Afganistán,0,2,0,2
2016,Mayo,5,5/1/2016,Albania,1,3,0,4
2016,Mayo,5,5/1/2016,Alemania,1410,2409,0,3819
2016,Mayo,5,5/1/2016,Andorra,6,15,0,21
2016,Mayo,5,5/1/2016,Angola,1,1,0,2
2016,Mayo,5,5/1/2016,Antigua y Barbuda,2,8,0,10
2016,Mayo,5,5/1/2016,Países Bajos,1476,2168,0,3644
2016,Mayo,5,5/1/2016,Arabia Saudita,0,24,0,24
2016,Mayo,5,5/1/2016,Argelia,0,2,0,2
2016,Mayo,5,5/1/2016,Argentina,4510,6385,0,10895
2016,Mayo,5,5/1/2016,República de Armenia,1,0,0,1
2016,Mayo,5,5/1/2016,Australia,443,791,0,1234
2016,Mayo,5,5/1/2016,Austria,128,217,0,345
2016,Mayo,5,5/1/2016,Azerbaiyán,3,7,0,10
2016,Mayo,5,5/1/2016,Bahamas,5,13,0,18
2016,Mayo,5,5/1/2016,Bahréin,1,2,0,3
2016,Mayo,5,5/1/2016,Bangladesh,1,3,0,4
2016,Mayo,5,5/1/2016,Barbados,12,27,0,39
2016,Mayo,5,5/1/2016,República de Belarús,1,7,0,8
2016,Mayo,5,5/1/2016,Bélgica,170,406,0,576
2016,Mayo,5,5/1/2016,Belice,8,18,0,26
2016,Mayo,5,5/1/2016,Bermudas/Territorio Británico de Ultramar,1,4,0,5
2016,Mayo,5,5/1/2016,Bolivia,679,741,0,1420
2016,Mayo,5,5/1/2016,Bosnia y Herzegovina,1,2,0,3
2016,Mayo,5,5/1/2016,Botsuana,1,0,0,1
2016,Mayo,5,5/1/2016,Brasil,7327,8088,0,15415
2016,Mayo,5,5/1/2016,Brunei Darussalam,0,1,0,1
2016,Mayo,5,5/1/2016,Bulgaria,27,37,0,64
2016,Mayo,5,5/1/2016,Burkina Faso,1,1,0,2
2016,Mayo,5,5/1/2016,Burundi,1,0,0,1
2016,Mayo,5,5/1/2016,Islas Caimán/Territorio Británico de Ultramar,5,0,0,5
2016,Mayo,5,5/1/2016,Camboya,1,0,0,1
2016,Mayo,5,5/1/2016,Camerún,0,3,0,3
2016,Mayo,5,5/1/2016,Guernsey,0,1,0,1
2016,Mayo,5,5/1/2016,Canadá,1091,1876,0,2967
2016,Mayo,5,5/1/2016,España,2357,5994,0,8351
2016,Mayo,5,5/1/2016,República Democrática del Congo,1,2,0,3
2016,Mayo,5,5/1/2016,Islas Heard Y Mcdonald,1,0,0,1
2016,Mayo,5,5/1/2016,República de Corea,194,514,0,708
2016,Mayo,5,5/1/2016,Costa Rica,1019,1465,0,2484
2016,Mayo,5,5/1/2016,Croacia,11,35,0,46
2016,Mayo,5,5/1/2016,Cuba,202,466,0,668
2016,Mayo,5,5/1/2016,República Checa,68,100,0,168
2016,Mayo,5,5/1/2016,Chile,4352,5527,0,9879
2016,Mayo,5,5/1/2016,China,383,964,0,1347
2016,Mayo,5,5/1/2016,Chipre,2,5,0,7
2016,Mayo,5,5/1/2016,Dinamarca,113,195,0,308
2016,Mayo,5,5/1/2016,Dominica,0,3,0,3
2016,Mayo,5,5/1/2016,Ecuador,4342,6850,0,11192
2016,Mayo,5,5/1/2016,Egipto,5,23,0,28
2016,Mayo,5,5/1/2016,El Salvador,876,1176,0,2052
2016,Mayo,5,5/1/2016,Emiratos Árabes,2,6,0,8
2016,Mayo,5,5/1/2016,Eslovaquia,16,39,0,55
2016,Mayo,5,5/1/2016,Eslovenia,10,30,0,40
2016,Mayo,5,5/1/2016,Estados Unidos de América,13807,24629,0,38436
2016,Mayo,5,5/1/2016,Estonia,13,15,0,28
2016,Mayo,5,5/1/2016,Etiopia,0,5,0,5
2016,Mayo,5,5/1/2016,Filipinas,36,225,0,261
2016,Mayo,5,5/1/2016,Finlandia,54,68,0,122
2016,Mayo,5,5/1/2016,Francia,1443,2592,0,4035
2016,Mayo,5,5/1/2016,Georgia,2,6,0,8
2016,Mayo,5,5/1/2016,Ghana,4,13,0,17
2016,Mayo,5,5/1/2016,Granada,2,2,0,4
2016,Mayo,5,5/1/2016,Grecia,34,72,0,106
2016,Mayo,5,5/1/2016,Guatemala,551,1189,0,1740
2016,Mayo,5,5/1/2016,Guyana,10,14,0,24
2016,Mayo,5,5/1/2016,Guinea Ecuatorial,0,1,0,1
2016,Mayo,5,5/1/2016,Guinea Bissau,1,1,0,2
2016,Mayo,5,5/1/2016,Haití,8,18,0,26
2016,Mayo,5,5/1/2016,Honduras,334,430,0,764
2016,Mayo,5,5/1/2016,Hong Kong,1,6,0,7
2016,Mayo,5,5/1/2016,Hungría,24,41,0,65
2016,Mayo,5,5/1/2016,India,86,534,0,620
2016,Mayo,5,5/1/2016,Indonesia,11,47,0,58
2016,Mayo,5,5/1/2016,Iraq,1,1,0,2
2016,Mayo,5,5/1/2016,Irán,3,7,0,10
2016,Mayo,5,5/1/2016,República de Irlanda,152,298,0,450
2016,Mayo,5,5/1/2016,Islandia,11,19,0,30
2016,Mayo,5,5/1/2016,Israel,478,1233,0,1711
2016,Mayo,5,5/1/2016,Italia,640,1905,0,2545
2016,Mayo,5,5/1/2016,Jamaica,22,38,0,60
2016,Mayo,5,5/1/2016,Islas Salomón,0,1,0,1
2016,Mayo,5,5/1/2016,Japón,146,534,0,680
2016,Mayo,5,5/1/2016,Jordania,3,6,0,9
2016,Mayo,5,5/1/2016,Kazajistán,6,2,0,8
2016,Mayo,5,5/1/2016,Kenia,5,9,0,14
2016,Mayo,5,5/1/2016,Kirguistán,1,0,0,1
2016,Mayo,5,5/1/2016,Kuwait,1,2,0,3
2016,Mayo,5,5/1/2016,República de Kosovo,0,1,0,1
2016,Mayo,5,5/1/2016,Letonia,10,45,0,55
2016,Mayo,5,5/1/2016,Lituania,26,43,0,69
2016,Mayo,5,5/1/2016,Líbano,12,32,0,44
2016,Mayo,5,5/1/2016,Liechtenstein,3,1,0,4
2016,Mayo,5,5/1/2016,Luxemburgo,4,14,0,18
2016,Mayo,5,5/1/2016,Macedonia,1,2,0,3
2016,Mayo,5,5/1/2016,Malasia,17,36,0,53
2016,Mayo,5,5/1/2016,Malta,4,13,0,17
2016,Mayo,5,5/1/2016,Marruecos,4,10,0,14
2016,Mayo,5,5/1/2016,Mauricio,1,2,0,3
2016,Mayo,5,5/1/2016,México,4294,8321,0,12615
2016,Mayo,5,5/1/2016,República de Moldavia,2,0,0,2
2016,Mayo,5,5/1/2016,Mongolia,1,0,0,1
2016,Mayo,5,5/1/2016,Montenegro,0,1,0,1
2016,Mayo,5,5/1/2016,Mozambique,1,1,0,2
2016,Mayo,5,5/1/2016,Myanmar,0,1,0,1
2016,Mayo,5,5/1/2016,Namibia,1,0,0,1
2016,Mayo,5,5/1/2016,Nepal,2,2,0,4
2016,Mayo,5,5/1/2016,Nicaragua,67,126,0,193
2016,Mayo,5,5/1/2016,Nigeria,7,20,0,27
2016,Mayo,5,5/1/2016,Noruega,83,153,0,236
2016,Mayo,5,5/1/2016,Nueva Zelanda,124,190,0,314
2016,Mayo,5,5/1/2016,Pakistán,7,18,0,25
2016,Mayo,5,5/1/2016,Panamá,2794,3067,0,5861
2016,Mayo,5,5/1/2016,Paraguay,259,227,0,486
2016,Mayo,5,5/1/2016,Perú,4667,5968,0,10635
2016,Mayo,5,5/1/2016,Palestina,0,1,0,1
2016,Mayo,5,5/1/2016,Polonia,112,169,0,281
2016,Mayo,5,5/1/2016,Portugal,185,478,0,663
2016,Mayo,5,5/1/2016,Reino Unido de Gran Bretaña e Irlanda del Norte,1254,2371,0,3625
2016,Mayo,5,5/1/2016,República CentroÁfricana,5,0,0,5
2016,Mayo,5,5/1/2016,Federación de Rusia,155,226,0,381
2016,Mayo,5,5/1/2016,República Dominicana,426,678,0,1104
2016,Mayo,5,5/1/2016,Rumania,63,100,0,163
2016,Mayo,5,5/1/2016,Rwanda,1,3,0,4
2016,Mayo,5,5/1/2016,San Cristóbal y Nevis,0,5,0,5
2016,Mayo,5,5/1/2016,Samoa Estadounidense/Territorio no incorporado de Estados Unidos,0,1,0,1
2016,Mayo,5,5/1/2016,San  Vicente y las Granadinas,2,4,0,6
2016,Mayo,5,5/1/2016,Santa Lucia,1,4,0,5
2016,Mayo,5,5/1/2016,Santa Sede/Ciudad del Vaticano,0,2,0,2
2016,Mayo,5,5/1/2016,Senegal,1,3,0,4
2016,Mayo,5,5/1/2016,Serbia,7,18,0,25
2016,Mayo,5,5/1/2016,Sierra Leona,0,1,0,1
2016,Mayo,5,5/1/2016,Singapur,20,37,0,57
2016,Mayo,5,5/1/2016,República Árabe Siria,1,3,0,4
2016,Mayo,5,5/1/2016,Sri Lanka,2,12,0,14
2016,Mayo,5,5/1/2016,Sudáfrica,46,93,0,139
2016,Mayo,5,5/1/2016,Sudán,1,1,0,2
2016,Mayo,5,5/1/2016,Suecia,174,288,0,462
2016,Mayo,5,5/1/2016,Suiza,399,717,0,1116
2016,Mayo,5,5/1/2016,Surinam,20,46,0,66
2016,Mayo,5,5/1/2016,Taiwán,56,111,0,167
2016,Mayo,5,5/1/2016,República de Tayikistán,1,0,0,1
2016,Mayo,5,5/1/2016,Tailandia,11,16,0,27
2016,Mayo,5,5/1/2016,Trinidad y Tobago,15,82,0,97
2016,Mayo,5,5/1/2016,Túnez,2,9,0,11
2016,Mayo,5,5/1/2016,Turquía,173,392,0,565
2016,Mayo,5,5/1/2016,Ucrania,24,33,0,57
2016,Mayo,5,5/1/2016,Uganda,1,1,0,2
2016,Mayo,5,5/1/2016,Uruguay,364,565,0,929
2016,Mayo,5,5/1/2016,Uzbekistán,1,1,0,2
2016,Mayo,5,5/1/2016,Venezuela,7625,9741,0,17366
2016,Mayo,5,5/1/2016,Vietnam,5,3,0,8
2016,Mayo,5,5/1/2016,Islas Vírgenes Británicas/Territorio Británico de Ultramar,0,1,0,1
2016,Mayo,5,5/1/2016,República Árabe de Yemen,0,2,0,2
2016,Mayo,5,5/1/2016,Zambia,1,3,0,4
2016,Mayo,5,5/1/2016,Zimbabue,1,8,0,9
2016,Mayo,5,5/1/2016,Islas Turcas y Caicos/Territorio Británico de Ultramar,0,1,0,1
2016,Mayo,5,5/1/2016,Desconocido,69,128,0,197
2016,Junio,6,6/1/2016,Albania,1,2,0,3
2016,Junio,6,6/1/2016,Alemania,1383,2203,0,3586
2016,Junio,6,6/1/2016,Andorra,1,9,0,10
2016,Junio,6,6/1/2016,Angola,0,2,0,2
2016,Junio,6,6/1/2016,Antigua y Barbuda,2,7,0,9
2016,Junio,6,6/1/2016,Países Bajos,1335,1929,0,3264
2016,Junio,6,6/1/2016,Arabia Saudita,0,5,0,5
2016,Junio,6,6/1/2016,Argelia,1,4,0,5
2016,Junio,6,6/1/2016,Argentina,3643,5548,0,9191
2016,Junio,6,6/1/2016,Aruba,0,1,0,1
2016,Junio,6,6/1/2016,Australia,456,708,0,1164
2016,Junio,6,6/1/2016,Austria,127,216,0,343
2016,Junio,6,6/1/2016,Azerbaiyán,2,0,0,2
2016,Junio,6,6/1/2016,Bahamas,10,13,0,23
2016,Junio,6,6/1/2016,Bahréin,1,1,0,2
2016,Junio,6,6/1/2016,Bangladesh,1,1,0,2
2016,Junio,6,6/1/2016,Barbados,10,17,0,27
2016,Junio,6,6/1/2016,República de Belarús,5,7,0,12
2016,Junio,6,6/1/2016,Bélgica,291,501,0,792
2016,Junio,6,6/1/2016,Belice,8,13,0,21
2016,Junio,6,6/1/2016,Bermudas/Territorio Británico de Ultramar,0,3,0,3
2016,Junio,6,6/1/2016,Bolivia,786,855,0,1641
2016,Junio,6,6/1/2016,Bosnia y Herzegovina,1,0,0,1
2016,Junio,6,6/1/2016,Botsuana,1,0,0,1
2016,Junio,6,6/1/2016,Brasil,5359,6908,0,12267
2016,Junio,6,6/1/2016,Bulgaria,19,28,0,47
2016,Junio,6,6/1/2016,Burkina Faso,0,1,0,1
2016,Junio,6,6/1/2016,Cabo Verde,1,0,0,1
2016,Junio,6,6/1/2016,Islas Caimán/Territorio Británico de Ultramar,2,4,0,6
2016,Junio,6,6/1/2016,Camerún,2,2,0,4
2016,Junio,6,6/1/2016,Canadá,1033,1802,0,2835
2016,Junio,6,6/1/2016,Chad,0,1,0,1
2016,Junio,6,6/1/2016,España,3062,6507,0,9569
2016,Junio,6,6/1/2016,República Democrática del Congo,0,5,0,5
2016,Junio,6,6/1/2016,República de Corea,258,536,0,794
2016,Junio,6,6/1/2016,Costa de Marfil,2,1,0,3
2016,Junio,6,6/1/2016,Costa Rica,1175,1546,0,2721
2016,Junio,6,6/1/2016,Croacia,14,49,0,63
2016,Junio,6,6/1/2016,Cuba,184,403,0,587
2016,Junio,6,6/1/2016,República Checa,50,87,0,137
2016,Junio,6,6/1/2016,Chile,4230,5741,0,9971
2016,Junio,6,6/1/2016,China,367,886,0,1253
2016,Junio,6,6/1/2016,Chipre,2,3,0,5
2016,Junio,6,6/1/2016,Dinamarca,151,229,0,380
2016,Junio,6,6/1/2016,Dominica,3,2,0,5
2016,Junio,6,6/1/2016,Ecuador,4376,6631,0,11007
2016,Junio,6,6/1/2016,Egipto,5,22,0,27
2016,Junio,6,6/1/2016,El Salvador,907,1195,0,2102
2016,Junio,6,6/1/2016,Emiratos Árabes,1,1,0,2
2016,Junio,6,6/1/2016,Eritrea,0,1,0,1
2016,Junio,6,6/1/2016,Eslovaquia,18,29,0,47
2016,Junio,6,6/1/2016,Eslovenia,18,30,0,48
2016,Junio,6,6/1/2016,Estados Unidos de América,21673,31263,0,52936
2016,Junio,6,6/1/2016,Estonia,9,12,0,21
2016,Junio,6,6/1/2016,Etiopia,1,13,0,14
2016,Junio,6,6/1/2016,Filipinas,38,243,0,281
2016,Junio,6,6/1/2016,Finlandia,48,85,0,133
2016,Junio,6,6/1/2016,Francia,1525,2507,0,4032
2016,Junio,6,6/1/2016,Georgia,1,7,0,8
2016,Junio,6,6/1/2016,Ghana,2,3,0,5
2016,Junio,6,6/1/2016,Granada,1,5,0,6
2016,Junio,6,6/1/2016,Grecia,25,83,0,108
2016,Junio,6,6/1/2016,Guatemala,697,1181,0,1878
2016,Junio,6,6/1/2016,Guyana,3,18,0,21
2016,Junio,6,6/1/2016,Guinea Ecuatorial,1,0,0,1
2016,Junio,6,6/1/2016,Haití,9,31,0,40
2016,Junio,6,6/1/2016,Honduras,327,446,0,773
2016,Junio,6,6/1/2016,Hong Kong,2,6,0,8
2016,Junio,6,6/1/2016,Hungría,23,54,0,77
2016,Junio,6,6/1/2016,India,96,483,0,579
2016,Junio,6,6/1/2016,Indonesia,10,22,0,32
2016,Junio,6,6/1/2016,Iraq,0,2,0,2
2016,Junio,6,6/1/2016,Irán,5,16,0,21
2016,Junio,6,6/1/2016,República de Irlanda,131,235,0,366
2016,Junio,6,6/1/2016,Islandia,10,9,0,19
2016,Junio,6,6/1/2016,Israel,285,768,0,1053
2016,Junio,6,6/1/2016,Italia,730,2079,0,2809
2016,Junio,6,6/1/2016,Jamaica,18,69,0,87
2016,Junio,6,6/1/2016,Islas Salomón,1,0,0,1
2016,Junio,6,6/1/2016,Japón,133,480,0,613
2016,Junio,6,6/1/2016,Jordania,3,4,0,7
2016,Junio,6,6/1/2016,Kazajistán,22,13,0,35
2016,Junio,6,6/1/2016,Kenia,5,15,0,20
2016,Junio,6,6/1/2016,Kiribati,0,1,0,1
2016,Junio,6,6/1/2016,Kirguistán,0,1,0,1
2016,Junio,6,6/1/2016,Kuwait,1,0,0,1
2016,Junio,6,6/1/2016,República de Kosovo,0,1,0,1
2016,Junio,6,6/1/2016,Lesoto,0,1,0,1
2016,Junio,6,6/1/2016,Letonia,12,20,0,32
2016,Junio,6,6/1/2016,Lituania,25,34,0,59
2016,Junio,6,6/1/2016,Líbano,9,17,0,26
2016,Junio,6,6/1/2016,Libia,0,1,0,1
2016,Junio,6,6/1/2016,Liechtenstein,3,1,0,4
2016,Junio,6,6/1/2016,Luxemburgo,3,12,0,15
2016,Junio,6,6/1/2016,Macedonia,0,4,0,4
2016,Junio,6,6/1/2016,Madagascar,3,0,0,3
2016,Junio,6,6/1/2016,Malasia,22,34,0,56
2016,Junio,6,6/1/2016,Malta,9,14,0,23
2016,Junio,6,6/1/2016,Marruecos,6,6,0,12
2016,Junio,6,6/1/2016,Mauricio,1,4,0,5
2016,Junio,6,6/1/2016,México,5246,9021,0,14267
2016,Junio,6,6/1/2016,República de Moldavia,5,0,0,5
2016,Junio,6,6/1/2016,Montenegro,0,1,0,1
2016,Junio,6,6/1/2016,Myanmar,1,3,0,4
2016,Junio,6,6/1/2016,Namibia,1,2,0,3
2016,Junio,6,6/1/2016,Nepal,1,1,0,2
2016,Junio,6,6/1/2016,Nicaragua,148,139,0,287
2016,Junio,6,6/1/2016,Nigeria,4,17,0,21
2016,Junio,6,6/1/2016,Noruega,191,267,0,458
2016,Junio,6,6/1/2016,Nueva Zelanda,97,154,0,251
2016,Junio,6,6/1/2016,Omán,0,2,0,2
2016,Junio,6,6/1/2016,Pakistán,5,20,0,25
2016,Junio,6,6/1/2016,Panamá,3851,3631,0,7482
2016,Junio,6,6/1/2016,Paraguay,343,285,0,628
2016,Junio,6,6/1/2016,Perú,5841,7649,0,13490
2016,Junio,6,6/1/2016,Palestina,2,1,0,3
2016,Junio,6,6/1/2016,Polonia,107,195,0,302
2016,Junio,6,6/1/2016,Portugal,150,394,0,544
2016,Junio,6,6/1/2016,Reino Unido de Gran Bretaña e Irlanda del Norte,1243,2196,0,3439
2016,Junio,6,6/1/2016,República CentroÁfricana,2,0,0,2
2016,Junio,6,6/1/2016,Federación de Rusia,128,217,0,345
2016,Junio,6,6/1/2016,República Dominicana,582,742,0,1324
2016,Junio,6,6/1/2016,Rumania,54,73,0,127
2016,Junio,6,6/1/2016,Rwanda,1,7,0,8
2016,Junio,6,6/1/2016,San Cristóbal y Nevis,1,3,0,4
2016,Junio,6,6/1/2016,San Marino,1,0,0,1
2016,Junio,6,6/1/2016,San  Vicente y las Granadinas,2,2,0,4
2016,Junio,6,6/1/2016,Santa Lucia,5,8,0,13
2016,Junio,6,6/1/2016,Santa Sede/Ciudad del Vaticano,0,2,0,2
2016,Junio,6,6/1/2016,Senegal,1,1,0,2
2016,Junio,6,6/1/2016,Serbia,4,5,0,9
2016,Junio,6,6/1/2016,Singapur,13,29,0,42
2016,Junio,6,6/1/2016,República Árabe Siria,5,2,0,7
2016,Junio,6,6/1/2016,Sri Lanka,4,5,0,9
2016,Junio,6,6/1/2016,Sudáfrica,49,107,0,156
2016,Junio,6,6/1/2016,Suecia,295,424,0,719
2016,Junio,6,6/1/2016,Suiza,487,708,0,1195
2016,Junio,6,6/1/2016,Surinam,12,35,0,47
2016,Junio,6,6/1/2016,Taiwán,87,89,0,176
2016,Junio,6,6/1/2016,Tailandia,17,9,0,26
2016,Junio,6,6/1/2016,Tanzania,1,3,0,4
2016,Junio,6,6/1/2016,Trinidad y Tobago,25,65,0,90
2016,Junio,6,6/1/2016,Túnez,3,4,0,7
2016,Junio,6,6/1/2016,Turquía,162,342,0,504
2016,Junio,6,6/1/2016,Ucrania,24,61,0,85
2016,Junio,6,6/1/2016,Uruguay,408,613,0,1021
2016,Junio,6,6/1/2016,Uzbekistán,1,0,0,1
2016,Junio,6,6/1/2016,Venezuela,8237,10313,0,18550
2016,Junio,6,6/1/2016,Vietnam,4,10,0,14
2016,Junio,6,6/1/2016,República Árabe de Yemen,0,1,0,1
2016,Junio,6,6/1/2016,Zambia,1,2,0,3
2016,Junio,6,6/1/2016,Zimbabue,0,3,0,3
2016,Junio,6,6/1/2016,Desconocido,80,168,0,248
2016,Julio,7,7/1/2016,Albania,3,4,0,7
2016,Julio,7,7/1/2016,Alemania,2472,3110,0,5582
2016,Julio,7,7/1/2016,Andorra,1,12,0,13
2016,Julio,7,7/1/2016,Angola,1,1,0,2
2016,Julio,7,7/1/2016,Antigua y Barbuda,0,4,0,4
2016,Julio,7,7/1/2016,Países Bajos,2846,3435,0,6281
2016,Julio,7,7/1/2016,Arabia Saudita,1,16,0,17
2016,Julio,7,7/1/2016,Argelia,1,5,0,6
2016,Julio,7,7/1/2016,Argentina,5233,6415,0,11648
2016,Julio,7,7/1/2016,República de Armenia,0,1,0,1
2016,Julio,7,7/1/2016,Australia,511,791,0,1302
2016,Julio,7,7/1/2016,Austria,274,353,0,627
2016,Julio,7,7/1/2016,Azerbaiyán,0,3,0,3
2016,Julio,7,7/1/2016,Bahamas,14,12,0,26
2016,Julio,7,7/1/2016,Bahréin,2,0,0,2
2016,Julio,7,7/1/2016,Bangladesh,1,3,0,4
2016,Julio,7,7/1/2016,Barbados,16,24,0,40
2016,Julio,7,7/1/2016,República de Belarús,7,8,0,15
2016,Julio,7,7/1/2016,Bélgica,532,735,0,1267
2016,Julio,7,7/1/2016,Belice,15,24,0,39
2016,Julio,7,7/1/2016,Benín,1,2,0,3
2016,Julio,7,7/1/2016,Bermudas/Territorio Británico de Ultramar,0,3,0,3
2016,Julio,7,7/1/2016,Bolivia,890,917,0,1807
2016,Julio,7,7/1/2016,Bosnia y Herzegovina,2,4,0,6
2016,Julio,7,7/1/2016,Botsuana,1,0,0,1
2016,Julio,7,7/1/2016,Brasil,6826,7627,0,14453
2016,Julio,7,7/1/2016,Bulgaria,20,26,0,46
2016,Julio,7,7/1/2016,Burkina Faso,0,5,0,5
2016,Julio,7,7/1/2016,Cabo Verde,4,0,0,4
2016,Julio,7,7/1/2016,Islas Caimán/Territorio Británico de Ultramar,6,5,0,11
2016,Julio,7,7/1/2016,Camboya,1,4,0,5
2016,Julio,7,7/1/2016,Camerún,0,3,0,3
2016,Julio,7,7/1/2016,Canadá,1524,2130,0,3654
2016,Julio,7,7/1/2016,España,3664,6810,0,10474
2016,Julio,7,7/1/2016,República Democrática del Congo,5,4,0,9
2016,Julio,7,7/1/2016,República de Corea,276,483,0,759
2016,Julio,7,7/1/2016,Costa de Marfil,1,0,0,1
2016,Julio,7,7/1/2016,Costa Rica,1712,1975,0,3687
2016,Julio,7,7/1/2016,Croacia,9,44,0,53
2016,Julio,7,7/1/2016,Cuba,263,453,0,716
2016,Julio,7,7/1/2016,República Checa,50,57,0,107
2016,Julio,7,7/1/2016,Chile,5431,6009,0,11440
2016,Julio,7,7/1/2016,China,398,820,0,1218
2016,Julio,7,7/1/2016,Chipre,4,7,0,11
2016,Julio,7,7/1/2016,Dinamarca,205,284,0,489
2016,Julio,7,7/1/2016,Dominica,1,5,0,6
2016,Julio,7,7/1/2016,Ecuador,6662,8759,0,15421
2016,Julio,7,7/1/2016,Egipto,8,35,0,43
2016,Julio,7,7/1/2016,El Salvador,1095,1271,0,2366
2016,Julio,7,7/1/2016,Emiratos Árabes,6,22,0,28
2016,Julio,7,7/1/2016,Eritrea,1,2,0,3
2016,Julio,7,7/1/2016,Eslovaquia,27,28,0,55
2016,Julio,7,7/1/2016,Eslovenia,25,36,0,61
2016,Julio,7,7/1/2016,Estados Unidos de América,21440,30326,0,51766
2016,Julio,7,7/1/2016,Estonia,15,25,0,40
2016,Julio,7,7/1/2016,Etiopia,3,3,0,6
2016,Julio,7,7/1/2016,Islas Fiji,1,0,0,1
2016,Julio,7,7/1/2016,Filipinas,55,252,0,307
2016,Julio,7,7/1/2016,Finlandia,56,64,0,120
2016,Julio,7,7/1/2016,Francia,2924,3980,0,6904
2016,Julio,7,7/1/2016,Gabón,0,2,0,2
2016,Julio,7,7/1/2016,Georgia,6,6,0,12
2016,Julio,7,7/1/2016,Ghana,0,14,0,14
2016,Julio,7,7/1/2016,Granada,2,2,0,4
2016,Julio,7,7/1/2016,Grecia,42,76,0,118
2016,Julio,7,7/1/2016,Guatemala,558,1114,0,1672
2016,Julio,7,7/1/2016,Guyana,13,14,0,27
2016,Julio,7,7/1/2016,Guinea,1,0,0,1
2016,Julio,7,7/1/2016,Guinea Ecuatorial,0,1,0,1
2016,Julio,7,7/1/2016,Haití,15,33,0,48
2016,Julio,7,7/1/2016,Honduras,419,569,0,988
2016,Julio,7,7/1/2016,Hong Kong,5,13,0,18
2016,Julio,7,7/1/2016,Hungría,38,52,0,90
2016,Julio,7,7/1/2016,India,82,493,0,575
2016,Julio,7,7/1/2016,Indonesia,19,30,0,49
2016,Julio,7,7/1/2016,Irán,7,18,0,25
2016,Julio,7,7/1/2016,República de Irlanda,194,289,0,483
2016,Julio,7,7/1/2016,Islandia,4,9,0,13
2016,Julio,7,7/1/2016,Isla de Man,1,0,0,1
2016,Julio,7,7/1/2016,Israel,292,803,0,1095
2016,Julio,7,7/1/2016,Italia,958,2039,0,2997
2016,Julio,7,7/1/2016,Jamaica,38,41,0,79
2016,Julio,7,7/1/2016,Japón,214,585,0,799
2016,Julio,7,7/1/2016,Jordania,2,5,0,7
2016,Julio,7,7/1/2016,Kazajistán,3,0,0,3
2016,Julio,7,7/1/2016,Kenia,13,19,0,32
2016,Julio,7,7/1/2016,Kuwait,3,7,0,10
2016,Julio,7,7/1/2016,República de Kosovo,0,1,0,1
2016,Julio,7,7/1/2016,República Democrática Popular  Lao,0,1,0,1
2016,Julio,7,7/1/2016,Letonia,8,19,0,27
2016,Julio,7,7/1/2016,Lituania,34,33,0,67
2016,Julio,7,7/1/2016,Líbano,25,34,0,59
2016,Julio,7,7/1/2016,Liechtenstein,2,5,0,7
2016,Julio,7,7/1/2016,Luxemburgo,19,22,0,41
2016,Julio,7,7/1/2016,Macedonia,1,3,0,4
2016,Julio,7,7/1/2016,Madagascar,1,0,0,1
2016,Julio,7,7/1/2016,Malasia,14,16,0,30
2016,Julio,7,7/1/2016,Malta,5,13,0,18
2016,Julio,7,7/1/2016,Marruecos,13,23,0,36
2016,Julio,7,7/1/2016,Mauricio,2,4,0,6
2016,Julio,7,7/1/2016,Mauritania,1,1,0,2
2016,Julio,7,7/1/2016,México,6781,9793,0,16574
2016,Julio,7,7/1/2016,Mónaco,3,3,0,6
2016,Julio,7,7/1/2016,Mongolia,3,0,0,3
2016,Julio,7,7/1/2016,Montenegro,1,1,0,2
2016,Julio,7,7/1/2016,Mozambique,1,1,0,2
2016,Julio,7,7/1/2016,Myanmar,2,3,0,5
2016,Julio,7,7/1/2016,Nepal,1,2,0,3
2016,Julio,7,7/1/2016,Nicaragua,102,141,0,243
2016,Julio,7,7/1/2016,Nigeria,4,6,0,10
2016,Julio,7,7/1/2016,Noruega,184,260,0,444
2016,Julio,7,7/1/2016,Nueva Zelanda,117,176,0,293
2016,Julio,7,7/1/2016,Omán,0,2,0,2
2016,Julio,7,7/1/2016,Pakistán,1,11,0,12
2016,Julio,7,7/1/2016,Panamá,3356,3524,0,6880
2016,Julio,7,7/1/2016,Paraguay,241,259,0,500
2016,Julio,7,7/1/2016,Perú,6441,7110,0,13551
2016,Julio,7,7/1/2016,Palestina,3,0,0,3
2016,Julio,7,7/1/2016,Polonia,168,238,0,406
2016,Julio,7,7/1/2016,Portugal,193,458,0,651
2016,Julio,7,7/1/2016,Qatar,1,89,0,90
2016,Julio,7,7/1/2016,Reino Unido de Gran Bretaña e Irlanda del Norte,1779,2750,0,4529
2016,Julio,7,7/1/2016,Federación de Rusia,178,200,0,378
2016,Julio,7,7/1/2016,República Dominicana,734,964,0,1698
2016,Julio,7,7/1/2016,Rumania,60,79,0,139
2016,Julio,7,7/1/2016,San Cristóbal y Nevis,1,2,0,3
2016,Julio,7,7/1/2016,Samoa Estadounidense/Territorio no incorporado de Estados Unidos,0,1,0,1
2016,Julio,7,7/1/2016,San  Vicente y las Granadinas,1,1,0,2
2016,Julio,7,7/1/2016,Santa Lucia,1,4,0,5
2016,Julio,7,7/1/2016,Santo Tomé y Príncipe,0,1,0,1
2016,Julio,7,7/1/2016,Senegal,1,1,0,2
2016,Julio,7,7/1/2016,Serbia,9,13,0,22
2016,Julio,7,7/1/2016,Singapur,20,21,0,41
2016,Julio,7,7/1/2016,República Árabe Siria,0,1,0,1
2016,Julio,7,7/1/2016,Somalia,0,1,0,1
2016,Julio,7,7/1/2016,Sri Lanka,1,6,0,7
2016,Julio,7,7/1/2016,Sudáfrica,56,92,0,148
2016,Julio,7,7/1/2016,Suecia,216,290,0,506
2016,Julio,7,7/1/2016,Suiza,1002,1334,0,2336
2016,Julio,7,7/1/2016,Surinam,10,19,0,29
2016,Julio,7,7/1/2016,Taiwán,81,109,0,190
2016,Julio,7,7/1/2016,Tailandia,27,10,0,37
2016,Julio,7,7/1/2016,Togo,0,1,0,1
2016,Julio,7,7/1/2016,Trinidad y Tobago,60,79,0,139
2016,Julio,7,7/1/2016,Túnez,1,4,0,5
2016,Julio,7,7/1/2016,Turquía,204,339,0,543
2016,Julio,7,7/1/2016,Ucrania,28,35,0,63
2016,Julio,7,7/1/2016,Uganda,1,0,0,1
2016,Julio,7,7/1/2016,Uruguay,412,565,0,977
2016,Julio,7,7/1/2016,Uzbekistán,1,0,0,1
2016,Julio,7,7/1/2016,Venezuela,12409,14126,0,26535
2016,Julio,7,7/1/2016,Vietnam,23,24,0,47
2016,Julio,7,7/1/2016,Islas Vírgenes Británicas/Territorio Británico de Ultramar,1,1,0,2
2016,Julio,7,7/1/2016,Zimbabue,1,2,0,3
2016,Julio,7,7/1/2016,Anguila/Territorio Británico de Ultramar,0,1,0,1
2016,Julio,7,7/1/2016,Desconocido,58,140,0,198
2016,Agosto,8,8/1/2016,Albania,3,6,0,9
2016,Agosto,8,8/1/2016,Alemania,2617,3257,0,5874
2016,Agosto,8,8/1/2016,Andorra,3,8,0,11
2016,Agosto,8,8/1/2016,Angola,1,2,0,3
2016,Agosto,8,8/1/2016,Antigua y Barbuda,0,8,0,8
2016,Agosto,8,8/1/2016,Países Bajos,1689,2382,0,4071
2016,Agosto,8,8/1/2016,Arabia Saudita,2,13,0,15
2016,Agosto,8,8/1/2016,Argelia,2,9,0,11
2016,Agosto,8,8/1/2016,Argentina,4767,7034,0,11801
2016,Agosto,8,8/1/2016,República de Armenia,2,1,0,3
2016,Agosto,8,8/1/2016,Australia,488,781,0,1269
2016,Agosto,8,8/1/2016,Austria,199,310,0,509
2016,Agosto,8,8/1/2016,Azerbaiyán,1,3,0,4
2016,Agosto,8,8/1/2016,Bahamas,10,24,0,34
2016,Agosto,8,8/1/2016,Bahréin,1,0,0,1
2016,Agosto,8,8/1/2016,Bangladesh,1,3,0,4
2016,Agosto,8,8/1/2016,Barbados,53,37,0,90
2016,Agosto,8,8/1/2016,República de Belarús,6,6,0,12
2016,Agosto,8,8/1/2016,Bélgica,291,487,0,778
2016,Agosto,8,8/1/2016,Belice,12,15,0,27
2016,Agosto,8,8/1/2016,Benín,0,1,0,1
2016,Agosto,8,8/1/2016,Bermudas/Territorio Británico de Ultramar,0,1,0,1
2016,Agosto,8,8/1/2016,Bolivia,595,718,0,1313
2016,Agosto,8,8/1/2016,Bosnia y Herzegovina,2,2,0,4
2016,Agosto,8,8/1/2016,Brasil,6005,7169,0,13174
2016,Agosto,8,8/1/2016,Bulgaria,17,25,0,42
2016,Agosto,8,8/1/2016,Burkina Faso,0,3,0,3
2016,Agosto,8,8/1/2016,Islas Caimán/Territorio Británico de Ultramar,16,15,0,31
2016,Agosto,8,8/1/2016,Camboya,1,1,0,2
2016,Agosto,8,8/1/2016,Camerún,0,4,0,4
2016,Agosto,8,8/1/2016,Canadá,1224,1980,0,3204
2016,Agosto,8,8/1/2016,Chad,0,1,0,1
2016,Agosto,8,8/1/2016,España,4309,7354,0,11663
2016,Agosto,8,8/1/2016,República Del Congo,1,5,0,6
2016,Agosto,8,8/1/2016,República Democrática del Congo,0,5,0,5
2016,Agosto,8,8/1/2016,República de Corea,204,474,0,678
2016,Agosto,8,8/1/2016,Costa Rica,1350,1961,0,3311
2016,Agosto,8,8/1/2016,Croacia,10,56,0,66
2016,Agosto,8,8/1/2016,Cuba,243,459,0,702
2016,Agosto,8,8/1/2016,República Checa,41,53,0,94
2016,Agosto,8,8/1/2016,Chile,5757,6600,0,12357
2016,Agosto,8,8/1/2016,China,417,994,0,1411
2016,Agosto,8,8/1/2016,Chipre,1,10,0,11
2016,Agosto,8,8/1/2016,Dinamarca,84,172,0,256
2016,Agosto,8,8/1/2016,Dominica,0,5,0,5
2016,Agosto,8,8/1/2016,Ecuador,9423,11183,0,20606
2016,Agosto,8,8/1/2016,Egipto,13,23,0,36
2016,Agosto,8,8/1/2016,El Salvador,1427,1565,0,2992
2016,Agosto,8,8/1/2016,Emiratos Árabes,2,14,0,16
2016,Agosto,8,8/1/2016,Eritrea,0,1,0,1
2016,Agosto,8,8/1/2016,Eslovaquia,21,21,0,42
2016,Agosto,8,8/1/2016,Eslovenia,15,11,0,26
2016,Agosto,8,8/1/2016,Estados Unidos de América,16375,27326,0,43701
2016,Agosto,8,8/1/2016,Estonia,9,12,0,21
2016,Agosto,8,8/1/2016,Etiopia,1,7,0,8
2016,Agosto,8,8/1/2016,Islas Fiji,3,0,0,3
2016,Agosto,8,8/1/2016,Filipinas,53,261,0,314
2016,Agosto,8,8/1/2016,Finlandia,44,68,0,112
2016,Agosto,8,8/1/2016,Francia,2496,3686,0,6182
2016,Agosto,8,8/1/2016,Gambia,0,1,0,1
2016,Agosto,8,8/1/2016,Georgia,4,3,0,7
2016,Agosto,8,8/1/2016,Ghana,0,4,0,4
2016,Agosto,8,8/1/2016,Granada,1,3,0,4
2016,Agosto,8,8/1/2016,Grecia,47,81,0,128
2016,Agosto,8,8/1/2016,Guatemala,760,1455,0,2215
2016,Agosto,8,8/1/2016,Guyana,11,16,0,27
2016,Agosto,8,8/1/2016,Guinea,0,1,0,1
2016,Agosto,8,8/1/2016,Guinea Ecuatorial,2,1,0,3
2016,Agosto,8,8/1/2016,Haití,8,24,0,32
2016,Agosto,8,8/1/2016,Honduras,373,546,0,919
2016,Agosto,8,8/1/2016,Hong Kong,4,9,0,13
2016,Agosto,8,8/1/2016,Hungría,38,42,0,80
2016,Agosto,8,8/1/2016,India,88,533,0,621
2016,Agosto,8,8/1/2016,Indonesia,13,25,0,38
2016,Agosto,8,8/1/2016,Iraq,0,2,0,2
2016,Agosto,8,8/1/2016,Irán,6,20,0,26
2016,Agosto,8,8/1/2016,República de Irlanda,188,238,0,426
2016,Agosto,8,8/1/2016,Islandia,4,3,0,7
2016,Agosto,8,8/1/2016,Israel,285,826,0,1111
2016,Agosto,8,8/1/2016,Italia,1431,3018,0,4449
2016,Agosto,8,8/1/2016,Islas Christmas,0,1,0,1
2016,Agosto,8,8/1/2016,Jamaica,33,73,0,106
2016,Agosto,8,8/1/2016,Islas Salomón,0,2,0,2
2016,Agosto,8,8/1/2016,Japón,228,495,0,723
2016,Agosto,8,8/1/2016,Jordania,2,8,0,10
2016,Agosto,8,8/1/2016,Kazajistán,5,4,0,9
2016,Agosto,8,8/1/2016,Kenia,11,10,0,21
2016,Agosto,8,8/1/2016,Kuwait,0,8,0,8
2016,Agosto,8,8/1/2016,República de Kosovo,1,1,0,2
2016,Agosto,8,8/1/2016,Lesoto,2,1,0,3
2016,Agosto,8,8/1/2016,Letonia,5,15,0,20
2016,Agosto,8,8/1/2016,Lituania,23,28,0,51
2016,Agosto,8,8/1/2016,Líbano,33,31,0,64
2016,Agosto,8,8/1/2016,Liberia,2,0,0,2
2016,Agosto,8,8/1/2016,Liechtenstein,1,1,0,2
2016,Agosto,8,8/1/2016,Luxemburgo,14,23,0,37
2016,Agosto,8,8/1/2016,Macedonia,1,2,0,3
2016,Agosto,8,8/1/2016,Madagascar,1,0,0,1
2016,Agosto,8,8/1/2016,Malasia,12,20,0,32
2016,Agosto,8,8/1/2016,Malta,6,9,0,15
2016,Agosto,8,8/1/2016,Marruecos,17,26,0,43
2016,Agosto,8,8/1/2016,Mauricio,0,3,0,3
2016,Agosto,8,8/1/2016,México,5383,9428,0,14811
2016,Agosto,8,8/1/2016,República de Moldavia,3,1,0,4
2016,Agosto,8,8/1/2016,Mónaco,0,1,0,1
2016,Agosto,8,8/1/2016,Mongolia,0,1,0,1
2016,Agosto,8,8/1/2016,Montenegro,0,1,0,1
2016,Agosto,8,8/1/2016,Mozambique,2,3,0,5
2016,Agosto,8,8/1/2016,Myanmar,0,4,0,4
2016,Agosto,8,8/1/2016,Nepal,0,6,0,6
2016,Agosto,8,8/1/2016,Nicaragua,147,163,0,310
2016,Agosto,8,8/1/2016,Nigeria,4,19,0,23
2016,Agosto,8,8/1/2016,Níger,1,0,0,1
2016,Agosto,8,8/1/2016,Noruega,76,150,0,226
2016,Agosto,8,8/1/2016,Nueva Zelanda,107,176,0,283
2016,Agosto,8,8/1/2016,Omán,0,1,0,1
2016,Agosto,8,8/1/2016,Pakistán,5,8,0,13
2016,Agosto,8,8/1/2016,Panamá,4014,4276,0,8290
2016,Agosto,8,8/1/2016,Paraguay,302,319,0,621
2016,Agosto,8,8/1/2016,Perú,6066,7136,0,13202
2016,Agosto,8,8/1/2016,Palestina,3,3,0,6
2016,Agosto,8,8/1/2016,Polonia,139,206,0,345
2016,Agosto,8,8/1/2016,Portugal,302,542,0,844
2016,Agosto,8,8/1/2016,Qatar,0,4,0,4
2016,Agosto,8,8/1/2016,Reino Unido de Gran Bretaña e Irlanda del Norte,1370,2270,0,3640
2016,Agosto,8,8/1/2016,República CentroÁfricana,5,0,0,5
2016,Agosto,8,8/1/2016,Federación de Rusia,164,227,0,391
2016,Agosto,8,8/1/2016,República Dominicana,944,1149,0,2093
2016,Agosto,8,8/1/2016,Rumania,42,67,0,109
2016,Agosto,8,8/1/2016,San Cristóbal y Nevis,0,3,0,3
2016,Agosto,8,8/1/2016,Samoa Estadounidense/Territorio no incorporado de Estados Unidos,0,1,0,1
2016,Agosto,8,8/1/2016,Samoa Occidental,1,0,0,1
2016,Agosto,8,8/1/2016,San Marino,0,1,0,1
2016,Agosto,8,8/1/2016,San  Vicente y las Granadinas,2,3,0,5
2016,Agosto,8,8/1/2016,Santa Lucia,2,7,0,9
2016,Agosto,8,8/1/2016,Santa Sede/Ciudad del Vaticano,0,3,0,3
2016,Agosto,8,8/1/2016,Senegal,6,1,0,7
2016,Agosto,8,8/1/2016,Serbia,17,13,0,30
2016,Agosto,8,8/1/2016,Singapur,19,26,0,45
2016,Agosto,8,8/1/2016,República Árabe Siria,1,2,0,3
2016,Agosto,8,8/1/2016,Sri Lanka,4,8,0,12
2016,Agosto,8,8/1/2016,Sudáfrica,43,85,0,128
2016,Agosto,8,8/1/2016,Sudán,0,2,0,2
2016,Agosto,8,8/1/2016,Suecia,158,250,0,408
2016,Agosto,8,8/1/2016,Suiza,536,700,0,1236
2016,Agosto,8,8/1/2016,Surinam,41,42,0,83
2016,Agosto,8,8/1/2016,Suazilandia,0,1,0,1
2016,Agosto,8,8/1/2016,Taiwán,50,83,0,133
2016,Agosto,8,8/1/2016,República de Tayikistán,0,1,0,1
2016,Agosto,8,8/1/2016,Tailandia,14,13,0,27
2016,Agosto,8,8/1/2016,Tanzania,0,1,0,1
2016,Agosto,8,8/1/2016,Togo,1,1,0,2
2016,Agosto,8,8/1/2016,Trinidad y Tobago,50,91,0,141
2016,Agosto,8,8/1/2016,Túnez,3,3,0,6
2016,Agosto,8,8/1/2016,Turkmenistán,1,0,0,1
2016,Agosto,8,8/1/2016,Turquía,150,291,0,441
2016,Agosto,8,8/1/2016,Ucrania,25,41,0,66
2016,Agosto,8,8/1/2016,Uganda,0,1,0,1
2016,Agosto,8,8/1/2016,Uruguay,433,718,0,1151
2016,Agosto,8,8/1/2016,Uzbekistán,0,1,0,1
2016,Agosto,8,8/1/2016,Vanuatu,1,0,0,1
2016,Agosto,8,8/1/2016,Venezuela,28879,31072,0,59951
2016,Agosto,8,8/1/2016,Vietnam,1,1,0,2
2016,Agosto,8,8/1/2016,Zambia,0,2,0,2
2016,Agosto,8,8/1/2016,Zimbabue,1,1,0,2
2016,Agosto,8,8/1/2016,Anguila/Territorio Británico de Ultramar,0,1,0,1
2016,Agosto,8,8/1/2016,Desconocido,74,149,0,223
2016,Septiembre,9,9/1/2016,Albania,3,3,0,6
2016,Septiembre,9,9/1/2016,Alemania,1810,2803,0,4613
2016,Septiembre,9,9/1/2016,Andorra,2,10,0,12
2016,Septiembre,9,9/1/2016,Angola,18,3,0,21
2016,Septiembre,9,9/1/2016,Antigua y Barbuda,2,4,0,6
2016,Septiembre,9,9/1/2016,Países Bajos,1450,2138,0,3588
2016,Septiembre,9,9/1/2016,Arabia Saudita,0,6,0,6
2016,Septiembre,9,9/1/2016,Argelia,2,4,0,6
2016,Septiembre,9,9/1/2016,Argentina,4230,5890,0,10120
2016,Septiembre,9,9/1/2016,República de Armenia,1,0,0,1
2016,Septiembre,9,9/1/2016,Australia,454,708,0,1162
2016,Septiembre,9,9/1/2016,Austria,131,262,0,393
2016,Septiembre,9,9/1/2016,Azerbaiyán,2,28,0,30
2016,Septiembre,9,9/1/2016,Bahamas,14,27,0,41
2016,Septiembre,9,9/1/2016,Bahréin,5,1,0,6
2016,Septiembre,9,9/1/2016,Bangladesh,1,4,0,5
2016,Septiembre,9,9/1/2016,Barbados,9,15,0,24
2016,Septiembre,9,9/1/2016,República de Belarús,7,6,0,13
2016,Septiembre,9,9/1/2016,Bélgica,255,516,0,771
2016,Septiembre,9,9/1/2016,Belice,11,14,0,25
2016,Septiembre,9,9/1/2016,Benín,1,1,0,2
2016,Septiembre,9,9/1/2016,Bermudas/Territorio Británico de Ultramar,2,3,0,5
2016,Septiembre,9,9/1/2016,Bolivia,860,951,0,1811
2016,Septiembre,9,9/1/2016,Bosnia y Herzegovina,0,4,0,4
2016,Septiembre,9,9/1/2016,Botsuana,0,1,0,1
2016,Septiembre,9,9/1/2016,Brasil,7193,7775,0,14968
2016,Septiembre,9,9/1/2016,Bulgaria,25,31,0,56
2016,Septiembre,9,9/1/2016,Burkina Faso,0,3,0,3
2016,Septiembre,9,9/1/2016,Bután,0,1,0,1
2016,Septiembre,9,9/1/2016,Islas Caimán/Territorio Británico de Ultramar,5,7,0,12
2016,Septiembre,9,9/1/2016,Camerún,1,1,0,2
2016,Septiembre,9,9/1/2016,Canadá,851,1622,0,2473
2016,Septiembre,9,9/1/2016,España,3026,6726,0,9752
2016,Septiembre,9,9/1/2016,República Del Congo,0,1,0,1
2016,Septiembre,9,9/1/2016,República Democrática del Congo,2,3,0,5
2016,Septiembre,9,9/1/2016,República de Corea,170,504,0,674
2016,Septiembre,9,9/1/2016,Costa de Marfil,0,3,0,3
2016,Septiembre,9,9/1/2016,Costa Rica,1331,1771,0,3102
2016,Septiembre,9,9/1/2016,Croacia,10,34,0,44
2016,Septiembre,9,9/1/2016,Cuba,250,740,0,990
2016,Septiembre,9,9/1/2016,República Checa,45,98,0,143
2016,Septiembre,9,9/1/2016,Chile,4726,5692,0,10418
2016,Septiembre,9,9/1/2016,China,393,1026,0,1419
2016,Septiembre,9,9/1/2016,Chipre,4,4,0,8
2016,Septiembre,9,9/1/2016,Dinamarca,98,203,0,301
2016,Septiembre,9,9/1/2016,República de Yibuti,0,2,0,2
2016,Septiembre,9,9/1/2016,Dominica,2,7,0,9
2016,Septiembre,9,9/1/2016,Ecuador,5488,7837,0,13325
2016,Septiembre,9,9/1/2016,Egipto,7,48,0,55
2016,Septiembre,9,9/1/2016,El Salvador,1019,1281,0,2300
2016,Septiembre,9,9/1/2016,Emiratos Árabes,2,9,0,11
2016,Septiembre,9,9/1/2016,Eslovaquia,18,34,0,52
2016,Septiembre,9,9/1/2016,Eslovenia,16,27,0,43
2016,Septiembre,9,9/1/2016,Estados Unidos de América,11036,21905,0,32941
2016,Septiembre,9,9/1/2016,Estonia,10,11,0,21
2016,Septiembre,9,9/1/2016,Etiopia,0,2,0,2
2016,Septiembre,9,9/1/2016,Islas Fiji,0,2,0,2
2016,Septiembre,9,9/1/2016,Filipinas,46,236,0,282
2016,Septiembre,9,9/1/2016,Finlandia,45,57,0,102
2016,Septiembre,9,9/1/2016,Francia,1316,2338,0,3654
2016,Septiembre,9,9/1/2016,Georgia,0,12,0,12
2016,Septiembre,9,9/1/2016,Ghana,2,7,0,9
2016,Septiembre,9,9/1/2016,Granada,2,3,0,5
2016,Septiembre,9,9/1/2016,Grecia,27,94,0,121
2016,Septiembre,9,9/1/2016,Guatemala,810,1389,0,2199
2016,Septiembre,9,9/1/2016,Guyana,15,17,0,32
2016,Septiembre,9,9/1/2016,Guinea Ecuatorial,0,1,0,1
2016,Septiembre,9,9/1/2016,Guinea Bissau,2,0,0,2
2016,Septiembre,9,9/1/2016,Haití,9,18,0,27
2016,Septiembre,9,9/1/2016,Honduras,444,534,0,978
2016,Septiembre,9,9/1/2016,Hong Kong,13,17,0,30
2016,Septiembre,9,9/1/2016,Hungría,30,60,0,90
2016,Septiembre,9,9/1/2016,India,77,526,0,603
2016,Septiembre,9,9/1/2016,Indonesia,13,27,0,40
2016,Septiembre,9,9/1/2016,Iraq,0,2,0,2
2016,Septiembre,9,9/1/2016,Irán,10,65,0,75
2016,Septiembre,9,9/1/2016,República de Irlanda,147,264,0,411
2016,Septiembre,9,9/1/2016,Islandia,10,11,0,21
2016,Septiembre,9,9/1/2016,Israel,160,630,0,790
2016,Septiembre,9,9/1/2016,Italia,721,2198,0,2919
2016,Septiembre,9,9/1/2016,Jamaica,31,55,0,86
2016,Septiembre,9,9/1/2016,Islas Salomón,0,20,0,20
2016,Septiembre,9,9/1/2016,Japón,213,644,0,857
2016,Septiembre,9,9/1/2016,Jordania,4,6,0,10
2016,Septiembre,9,9/1/2016,Kazajistán,4,33,0,37
2016,Septiembre,9,9/1/2016,Kenia,9,12,0,21
2016,Septiembre,9,9/1/2016,Kirguistán,0,2,0,2
2016,Septiembre,9,9/1/2016,Kuwait,1,2,0,3
2016,Septiembre,9,9/1/2016,República de Kosovo,1,2,0,3
2016,Septiembre,9,9/1/2016,República Democrática Popular  Lao,1,2,0,3
2016,Septiembre,9,9/1/2016,Letonia,7,10,0,17
2016,Septiembre,9,9/1/2016,Lituania,34,40,0,74
2016,Septiembre,9,9/1/2016,Líbano,20,35,0,55
2016,Septiembre,9,9/1/2016,Libia,0,1,0,1
2016,Septiembre,9,9/1/2016,Liechtenstein,2,2,0,4
2016,Septiembre,9,9/1/2016,Luxemburgo,7,9,0,16
2016,Septiembre,9,9/1/2016,Macedonia,1,3,0,4
2016,Septiembre,9,9/1/2016,Madagascar,0,1,0,1
2016,Septiembre,9,9/1/2016,Malasia,18,50,0,68
2016,Septiembre,9,9/1/2016,Malí,0,1,0,1
2016,Septiembre,9,9/1/2016,Malta,7,12,0,19
2016,Septiembre,9,9/1/2016,Marruecos,9,48,0,57
2016,Septiembre,9,9/1/2016,Mauricio,1,4,0,5
2016,Septiembre,9,9/1/2016,México,5734,9948,0,15682
2016,Septiembre,9,9/1/2016,República de Moldavia,2,0,0,2
2016,Septiembre,9,9/1/2016,Montenegro,0,2,0,2
2016,Septiembre,9,9/1/2016,Mozambique,3,21,0,24
2016,Septiembre,9,9/1/2016,Myanmar,1,1,0,2
2016,Septiembre,9,9/1/2016,Namibia,0,1,0,1
2016,Septiembre,9,9/1/2016,Nepal,0,1,0,1
2016,Septiembre,9,9/1/2016,Nicaragua,143,178,0,321
2016,Septiembre,9,9/1/2016,Nigeria,2,11,0,13
2016,Septiembre,9,9/1/2016,Noruega,103,178,0,281
2016,Septiembre,9,9/1/2016,Nueva Zelanda,95,141,0,236
2016,Septiembre,9,9/1/2016,Omán,0,1,0,1
2016,Septiembre,9,9/1/2016,Pakistán,2,13,0,15
2016,Septiembre,9,9/1/2016,Panamá,4692,4373,0,9065
2016,Septiembre,9,9/1/2016,Paraguay,417,503,0,920
2016,Septiembre,9,9/1/2016,Perú,5207,6500,0,11707
2016,Septiembre,9,9/1/2016,Palestina,8,4,0,12
2016,Septiembre,9,9/1/2016,Polonia,119,186,0,305
2016,Septiembre,9,9/1/2016,Portugal,223,547,0,770
2016,Septiembre,9,9/1/2016,Qatar,0,1,0,1
2016,Octubre,10,10/1/2016,Argentina,4817,6273,0,11090
2016,Septiembre,9,9/1/2016,Reino Unido de Gran Bretaña e Irlanda del Norte,1040,2166,0,3206
2016,Septiembre,9,9/1/2016,Federación de Rusia,207,241,0,448
2016,Septiembre,9,9/1/2016,República Dominicana,769,1041,0,1810
2016,Septiembre,9,9/1/2016,República Democrática Popular de Corea,2,0,0,2
2016,Septiembre,9,9/1/2016,Rumania,66,75,0,141
2016,Septiembre,9,9/1/2016,Rwanda,0,14,0,14
2016,Septiembre,9,9/1/2016,San Cristóbal y Nevis,6,4,0,10
2016,Septiembre,9,9/1/2016,Samoa Estadounidense/Territorio no incorporado de Estados Unidos,0,1,0,1
2016,Septiembre,9,9/1/2016,San Marino,0,1,0,1
2016,Septiembre,9,9/1/2016,San  Vicente y las Granadinas,2,9,0,11
2016,Septiembre,9,9/1/2016,Santa Lucia,3,5,0,8
2016,Septiembre,9,9/1/2016,Santa Sede/Ciudad del Vaticano,0,3,0,3
2016,Septiembre,9,9/1/2016,Senegal,1,6,0,7
2016,Septiembre,9,9/1/2016,Serbia,10,7,0,17
2016,Septiembre,9,9/1/2016,Singapur,13,27,0,40
2016,Septiembre,9,9/1/2016,República Árabe Siria,0,6,0,6
2016,Septiembre,9,9/1/2016,Sri Lanka,1,4,0,5
2016,Septiembre,9,9/1/2016,Sudáfrica,51,101,0,152
2016,Septiembre,9,9/1/2016,Sudán,0,3,0,3
2016,Septiembre,9,9/1/2016,Suecia,161,267,0,428
2016,Septiembre,9,9/1/2016,Suiza,374,700,0,1074
2016,Septiembre,9,9/1/2016,Surinam,35,26,0,61
2016,Septiembre,9,9/1/2016,Taiwán,67,118,0,185
2016,Septiembre,9,9/1/2016,Tailandia,29,56,0,85
2016,Septiembre,9,9/1/2016,Tanzania,2,1,0,3
2016,Septiembre,9,9/1/2016,Togo,0,1,0,1
2016,Septiembre,9,9/1/2016,Trinidad y Tobago,25,59,0,84
2016,Septiembre,9,9/1/2016,Túnez,3,2,0,5
2016,Septiembre,9,9/1/2016,Turquía,214,391,0,605
2016,Septiembre,9,9/1/2016,Ucrania,23,58,0,81
2016,Septiembre,9,9/1/2016,Uruguay,465,639,0,1104
2016,Septiembre,9,9/1/2016,Uzbekistán,0,27,0,27
2016,Septiembre,9,9/1/2016,Venezuela,25081,29255,0,54336
2016,Septiembre,9,9/1/2016,Vietnam,9,31,0,40
2016,Septiembre,9,9/1/2016,Islas Vírgenes Británicas/Territorio Británico de Ultramar,1,1,0,2
2016,Septiembre,9,9/1/2016,República Árabe de Yemen,0,2,0,2
2016,Septiembre,9,9/1/2016,Zambia,0,1,0,1
2016,Septiembre,9,9/1/2016,Zimbabue,0,4,0,4
2016,Septiembre,9,9/1/2016,Anguila/Territorio Británico de Ultramar,1,1,0,2
2016,Septiembre,9,9/1/2016,Desconocido,74,159,0,233
2016,Octubre,10,10/1/2016,Albania,4,10,0,14
2016,Octubre,10,10/1/2016,Alemania,1864,3058,0,4922
2016,Octubre,10,10/1/2016,Andorra,5,15,0,20
2016,Octubre,10,10/1/2016,Angola,3,4,0,7
2016,Octubre,10,10/1/2016,Antigua y Barbuda,2,11,0,13
2016,Octubre,10,10/1/2016,Países Bajos,1588,2340,0,3928
2016,Octubre,10,10/1/2016,Arabia Saudita,1,9,0,10
2016,Octubre,10,10/1/2016,Argelia,4,6,0,10
2016,Octubre,10,10/1/2016,República de Armenia,3,4,0,7
2016,Octubre,10,10/1/2016,Australia,494,813,0,1307
2016,Octubre,10,10/1/2016,Austria,180,291,0,471
2016,Octubre,10,10/1/2016,Azerbaiyán,3,3,0,6
2016,Octubre,10,10/1/2016,Bahamas,5,9,0,14
2016,Octubre,10,10/1/2016,Bangladesh,0,2,0,2
2016,Octubre,10,10/1/2016,Barbados,17,18,0,35
2016,Octubre,10,10/1/2016,República de Belarús,6,9,0,15
2016,Octubre,10,10/1/2016,Bélgica,247,513,0,760
2016,Octubre,10,10/1/2016,Belice,7,21,0,28
2016,Octubre,10,10/1/2016,Benín,3,2,0,5
2016,Octubre,10,10/1/2016,Bermudas/Territorio Británico de Ultramar,1,5,0,6
2016,Octubre,10,10/1/2016,Bolivia,845,846,0,1691
2016,Octubre,10,10/1/2016,Bosnia y Herzegovina,1,3,0,4
2016,Octubre,10,10/1/2016,Botsuana,1,3,0,4
2016,Octubre,10,10/1/2016,Brasil,8386,8601,0,16987
2016,Octubre,10,10/1/2016,Bulgaria,25,51,0,76
2016,Octubre,10,10/1/2016,Burkina Faso,0,1,0,1
2016,Octubre,10,10/1/2016,Burundi,1,2,0,3
2016,Octubre,10,10/1/2016,Cabo Verde,1,1,0,2
2016,Octubre,10,10/1/2016,Islas Caimán/Territorio Británico de Ultramar,3,2,0,5
2016,Octubre,10,10/1/2016,Antártida,1,0,0,1
2016,Octubre,10,10/1/2016,Camerún,4,2,0,6
2016,Octubre,10,10/1/2016,Canadá,999,1909,0,2908
2016,Octubre,10,10/1/2016,España,3367,7135,0,10502
2016,Octubre,10,10/1/2016,República Del Congo,0,6,0,6
2016,Octubre,10,10/1/2016,Comoras,1,2,0,3
2016,Octubre,10,10/1/2016,República Democrática del Congo,3,2,0,5
2016,Octubre,10,10/1/2016,República de Corea,227,500,0,727
2016,Octubre,10,10/1/2016,Costa de Marfil,2,1,0,3
2016,Octubre,10,10/1/2016,Costa Rica,1403,1822,0,3225
2016,Octubre,10,10/1/2016,Croacia,23,51,0,74
2016,Octubre,10,10/1/2016,Cuba,253,479,0,732
2016,Octubre,10,10/1/2016,República Checa,70,101,0,171
2016,Octubre,10,10/1/2016,Chile,5958,6522,0,12480
2016,Octubre,10,10/1/2016,China,454,1015,0,1469
2016,Octubre,10,10/1/2016,Chipre,3,12,0,15
2016,Octubre,10,10/1/2016,Dinamarca,131,198,0,329
2016,Octubre,10,10/1/2016,Dominica,5,6,0,11
2016,Octubre,10,10/1/2016,Ecuador,6245,8458,0,14703
2016,Octubre,10,10/1/2016,Egipto,7,25,0,32
2016,Octubre,10,10/1/2016,El Salvador,1074,1364,0,2438
2016,Octubre,10,10/1/2016,Emiratos Árabes,0,11,0,11
2016,Octubre,10,10/1/2016,Eritrea,0,1,0,1
2016,Octubre,10,10/1/2016,Eslovaquia,47,54,0,101
2016,Octubre,10,10/1/2016,Eslovenia,19,30,0,49
2016,Octubre,10,10/1/2016,Estados Unidos de América,10621,20709,0,31330
2016,Octubre,10,10/1/2016,Estonia,20,34,0,54
2016,Octubre,10,10/1/2016,Etiopia,1,3,0,4
2016,Octubre,10,10/1/2016,Islas Fiji,0,1,0,1
2016,Octubre,10,10/1/2016,Filipinas,58,261,0,319
2016,Octubre,10,10/1/2016,Finlandia,60,94,0,154
2016,Octubre,10,10/1/2016,Francia,1714,2939,0,4653
2016,Octubre,10,10/1/2016,Gabón,2,2,0,4
2016,Octubre,10,10/1/2016,Georgia,6,11,0,17
2016,Octubre,10,10/1/2016,Ghana,2,9,0,11
2016,Octubre,10,10/1/2016,Granada,2,5,0,7
2016,Octubre,10,10/1/2016,Grecia,42,92,0,134
2016,Octubre,10,10/1/2016,Guatemala,877,1380,0,2257
2016,Octubre,10,10/1/2016,Guyana,15,16,0,31
2016,Octubre,10,10/1/2016,Guinea Ecuatorial,1,3,0,4
2016,Octubre,10,10/1/2016,Haití,7,26,0,33
2016,Octubre,10,10/1/2016,Honduras,674,823,0,1497
2016,Octubre,10,10/1/2016,Hong Kong,5,4,0,9
2016,Octubre,10,10/1/2016,Hungría,47,58,0,105
2016,Octubre,10,10/1/2016,India,72,485,0,557
2016,Octubre,10,10/1/2016,Indonesia,26,45,0,71
2016,Octubre,10,10/1/2016,Iraq,0,3,0,3
2016,Octubre,10,10/1/2016,Irán,7,19,0,26
2016,Octubre,10,10/1/2016,República de Irlanda,135,250,0,385
2016,Octubre,10,10/1/2016,Islandia,6,6,0,12
2016,Octubre,10,10/1/2016,Israel,146,519,0,665
2016,Octubre,10,10/1/2016,Italia,799,2269,0,3068
2016,Octubre,10,10/1/2016,Jamaica,64,78,0,142
2016,Octubre,10,10/1/2016,Islas Salomón,1,0,0,1
2016,Octubre,10,10/1/2016,Japón,153,565,0,718
2016,Octubre,10,10/1/2016,Jordania,3,5,0,8
2016,Octubre,10,10/1/2016,Kazajistán,2,4,0,6
2016,Octubre,10,10/1/2016,Kenia,9,11,0,20
2016,Octubre,10,10/1/2016,Kiribati,0,1,0,1
2016,Octubre,10,10/1/2016,Kirguistán,0,2,0,2
2016,Octubre,10,10/1/2016,Kuwait,0,2,0,2
2016,Octubre,10,10/1/2016,República de Kosovo,1,2,0,3
2016,Octubre,10,10/1/2016,Letonia,5,11,0,16
2016,Octubre,10,10/1/2016,Lituania,33,38,0,71
2016,Octubre,10,10/1/2016,Líbano,16,42,0,58
2016,Octubre,10,10/1/2016,Liberia,1,0,0,1
2016,Octubre,10,10/1/2016,Liechtenstein,0,1,0,1
2016,Octubre,10,10/1/2016,Luxemburgo,3,10,0,13
2016,Octubre,10,10/1/2016,Macedonia,1,1,0,2
2016,Octubre,10,10/1/2016,Madagascar,0,1,0,1
2016,Octubre,10,10/1/2016,Malasia,15,32,0,47
2016,Octubre,10,10/1/2016,Malawi,0,2,0,2
2016,Octubre,10,10/1/2016,Maldivas,1,0,0,1
2016,Octubre,10,10/1/2016,Malí,0,1,0,1
2016,Octubre,10,10/1/2016,Malta,2,9,0,11
2016,Octubre,10,10/1/2016,Marruecos,14,42,0,56
2016,Octubre,10,10/1/2016,Mauricio,2,6,0,8
2016,Octubre,10,10/1/2016,Mauritania,2,0,0,2
2016,Octubre,10,10/1/2016,México,4978,8851,0,13829
2016,Octubre,10,10/1/2016,República de Moldavia,1,0,0,1
2016,Octubre,10,10/1/2016,Mongolia,0,2,0,2
2016,Octubre,10,10/1/2016,Montenegro,0,2,0,2
2016,Octubre,10,10/1/2016,Mozambique,2,5,0,7
2016,Octubre,10,10/1/2016,Myanmar,0,1,0,1
2016,Octubre,10,10/1/2016,Namibia,1,1,0,2
2016,Octubre,10,10/1/2016,Nepal,2,6,0,8
2016,Octubre,10,10/1/2016,Nicaragua,129,157,0,286
2016,Octubre,10,10/1/2016,Nigeria,4,11,0,15
2016,Octubre,10,10/1/2016,Noruega,122,173,0,295
2016,Octubre,10,10/1/2016,Nueva Zelanda,82,161,0,243
2016,Octubre,10,10/1/2016,Papúa Nueva Guinea,5,2,0,7
2016,Octubre,10,10/1/2016,Pakistán,3,24,0,27
2016,Octubre,10,10/1/2016,Panamá,3540,3759,0,7299
2016,Octubre,10,10/1/2016,Paraguay,388,425,0,813
2016,Octubre,10,10/1/2016,Perú,6381,7669,0,14050
2016,Octubre,10,10/1/2016,Palestina,2,1,0,3
2016,Octubre,10,10/1/2016,Polonia,244,286,0,530
2016,Octubre,10,10/1/2016,Portugal,257,658,0,915
2016,Octubre,10,10/1/2016,Puerto Rico/Territorio de Estados Unidos,1,0,0,1
2016,Octubre,10,10/1/2016,Qatar,0,1,0,1
2016,Octubre,10,10/1/2016,Reino Unido de Gran Bretaña e Irlanda del Norte,1084,2196,0,3280
2016,Octubre,10,10/1/2016,República CentroÁfricana,0,2,0,2
2016,Octubre,10,10/1/2016,Federación de Rusia,240,351,0,591
2016,Octubre,10,10/1/2016,República Dominicana,753,1103,0,1856
2016,Octubre,10,10/1/2016,Rumania,73,120,0,193
2016,Octubre,10,10/1/2016,Rwanda,1,1,0,2
2016,Octubre,10,10/1/2016,San Cristóbal y Nevis,1,2,0,3
2016,Octubre,10,10/1/2016,San  Vicente y las Granadinas,3,4,0,7
2016,Octubre,10,10/1/2016,Santa Lucia,6,6,0,12
2016,Octubre,10,10/1/2016,Santa Sede/Ciudad del Vaticano,0,2,0,2
2016,Octubre,10,10/1/2016,Senegal,5,4,0,9
2016,Octubre,10,10/1/2016,Serbia,7,17,0,24
2016,Octubre,10,10/1/2016,Sierra Leona,1,3,0,4
2016,Octubre,10,10/1/2016,Singapur,21,40,0,61
2016,Octubre,10,10/1/2016,República Árabe Siria,2,0,0,2
2016,Octubre,10,10/1/2016,Somalia,0,2,0,2
2016,Octubre,10,10/1/2016,Sri Lanka,2,9,0,11
2016,Octubre,10,10/1/2016,Sudáfrica,69,149,0,218
2016,Octubre,10,10/1/2016,Sudán,0,1,0,1
2016,Octubre,10,10/1/2016,Suecia,209,339,0,548
2016,Octubre,10,10/1/2016,Suiza,470,783,0,1253
2016,Octubre,10,10/1/2016,Surinam,26,36,0,62
2016,Octubre,10,10/1/2016,Suazilandia,0,2,0,2
2016,Octubre,10,10/1/2016,Taiwán,95,122,0,217
2016,Octubre,10,10/1/2016,República de Tayikistán,1,1,0,2
2016,Octubre,10,10/1/2016,Tailandia,15,14,0,29
2016,Octubre,10,10/1/2016,Tanzania,1,0,0,1
2016,Octubre,10,10/1/2016,Togo,0,1,0,1
2016,Octubre,10,10/1/2016,Trinidad y Tobago,36,68,0,104
2016,Octubre,10,10/1/2016,Túnez,3,13,0,16
2016,Octubre,10,10/1/2016,Turquía,206,456,0,662
2016,Octubre,10,10/1/2016,Ucrania,36,46,0,82
2016,Octubre,10,10/1/2016,Uganda,3,2,0,5
2016,Octubre,10,10/1/2016,Uruguay,505,844,0,1349
2016,Octubre,10,10/1/2016,Uzbekistán,0,1,0,1
2016,Octubre,10,10/1/2016,Venezuela,19400,23501,0,42901
2016,Octubre,10,10/1/2016,Vietnam,1,30,0,31
2016,Octubre,10,10/1/2016,República Árabe de Yemen,0,1,0,1
2016,Octubre,10,10/1/2016,Zambia,1,3,0,4
2016,Octubre,10,10/1/2016,Zimbabue,0,6,0,6
2016,Octubre,10,10/1/2016,Desconocido,109,204,0,313
2016,Noviembre,11,11/1/2016,Afganistán,0,1,0,1
2016,Noviembre,11,11/1/2016,Albania,2,4,0,6
2016,Noviembre,11,11/1/2016,Alemania,1816,3051,0,4867
2016,Noviembre,11,11/1/2016,Andorra,2,16,0,18
2016,Noviembre,11,11/1/2016,Angola,1,2,0,3
2016,Noviembre,11,11/1/2016,Antigua y Barbuda,2,14,0,16
2016,Noviembre,11,11/1/2016,Países Bajos,1570,2321,0,3891
2016,Noviembre,11,11/1/2016,Arabia Saudita,0,3,0,3
2016,Noviembre,11,11/1/2016,Argelia,4,5,0,9
2016,Noviembre,11,11/1/2016,Argentina,5030,6677,0,11707
2016,Noviembre,11,11/1/2016,República de Armenia,1,2,0,3
2016,Noviembre,11,11/1/2016,Aruba,2,1,0,3
2016,Noviembre,11,11/1/2016,Australia,529,876,0,1405
2016,Noviembre,11,11/1/2016,Austria,180,349,0,529
2016,Noviembre,11,11/1/2016,Azerbaiyán,6,5,0,11
2016,Noviembre,11,11/1/2016,Bahamas,7,14,0,21
2016,Noviembre,11,11/1/2016,Bahréin,0,2,0,2
2016,Noviembre,11,11/1/2016,Bangladesh,1,5,0,6
2016,Noviembre,11,11/1/2016,Barbados,10,15,0,25
2016,Noviembre,11,11/1/2016,República de Belarús,4,3,0,7
2016,Noviembre,11,11/1/2016,Bélgica,296,567,0,863
2016,Noviembre,11,11/1/2016,Belice,5,25,0,30
2016,Noviembre,11,11/1/2016,Benín,1,4,0,5
2016,Noviembre,11,11/1/2016,Bermudas/Territorio Británico de Ultramar,0,3,0,3
2016,Noviembre,11,11/1/2016,Bolivia,777,922,0,1699
2016,Noviembre,11,11/1/2016,Bosnia y Herzegovina,0,1,0,1
2016,Noviembre,11,11/1/2016,Botsuana,1,0,0,1
2016,Noviembre,11,11/1/2016,Brasil,7207,8354,0,15561
2016,Noviembre,11,11/1/2016,Bulgaria,28,47,0,75
2016,Noviembre,11,11/1/2016,Burkina Faso,0,2,0,2
2016,Noviembre,11,11/1/2016,Burundi,0,1,0,1
2016,Noviembre,11,11/1/2016,Bután,0,2,0,2
2016,Noviembre,11,11/1/2016,Cabo Verde,0,1,0,1
2016,Noviembre,11,11/1/2016,Islas Caimán/Territorio Británico de Ultramar,2,4,0,6
2016,Noviembre,11,11/1/2016,Camerún,3,3,0,6
2016,Noviembre,11,11/1/2016,Canadá,1235,2385,0,3620
2016,Noviembre,11,11/1/2016,Chad,0,3,0,3
2016,Noviembre,11,11/1/2016,España,3722,8091,0,11813
2016,Noviembre,11,11/1/2016,República Del Congo,0,2,0,2
2016,Noviembre,11,11/1/2016,República Democrática del Congo,1,8,0,9
2016,Noviembre,11,11/1/2016,República de Corea,254,525,0,779
2016,Noviembre,11,11/1/2016,Costa de Marfil,1,2,0,3
2016,Noviembre,11,11/1/2016,Costa Rica,1459,1883,0,3342
2016,Noviembre,11,11/1/2016,Croacia,11,68,0,79
2016,Noviembre,11,11/1/2016,Cuba,241,435,0,676
2016,Noviembre,11,11/1/2016,República Checa,62,144,0,206
2016,Noviembre,11,11/1/2016,Chile,4963,6915,0,11878
2016,Noviembre,11,11/1/2016,China,452,1188,0,1640
2016,Noviembre,11,11/1/2016,Chipre,1,5,0,6
2016,Noviembre,11,11/1/2016,Dinamarca,129,226,0,355
2016,Noviembre,11,11/1/2016,Dominica,2,2,0,4
2016,Noviembre,11,11/1/2016,Ecuador,6765,8682,0,15447
2016,Noviembre,11,11/1/2016,Egipto,3,27,0,30
2016,Noviembre,11,11/1/2016,El Salvador,1367,1479,0,2846
2016,Noviembre,11,11/1/2016,Emiratos Árabes,1,16,0,17
2016,Noviembre,11,11/1/2016,Eritrea,0,1,0,1
2016,Noviembre,11,11/1/2016,Eslovaquia,35,54,0,89
2016,Noviembre,11,11/1/2016,Eslovenia,16,43,0,59
2016,Noviembre,11,11/1/2016,Estados Unidos de América,12780,23358,0,36138
2016,Noviembre,11,11/1/2016,Estonia,25,26,0,51
2016,Noviembre,11,11/1/2016,Etiopia,2,6,0,8
2016,Noviembre,11,11/1/2016,Islas Fiji,1,1,0,2
2016,Noviembre,11,11/1/2016,Filipinas,43,270,0,313
2016,Noviembre,11,11/1/2016,Finlandia,70,105,0,175
2016,Noviembre,11,11/1/2016,Francia,1636,2941,0,4577
2016,Noviembre,11,11/1/2016,Georgia,4,12,0,16
2016,Noviembre,11,11/1/2016,Ghana,5,11,0,16
2016,Noviembre,11,11/1/2016,Granada,4,6,0,10
2016,Noviembre,11,11/1/2016,Grecia,28,103,0,131
2016,Noviembre,11,11/1/2016,Guatemala,1019,1432,0,2451
2016,Noviembre,11,11/1/2016,Guyana,12,16,0,28
2016,Noviembre,11,11/1/2016,Guinea,0,1,0,1
2016,Noviembre,11,11/1/2016,Haití,20,24,0,44
2016,Noviembre,11,11/1/2016,Honduras,459,552,0,1011
2016,Noviembre,11,11/1/2016,Hong Kong,3,9,0,12
2016,Noviembre,11,11/1/2016,Hungría,50,71,0,121
2016,Noviembre,11,11/1/2016,India,96,618,0,714
2016,Noviembre,11,11/1/2016,Indonesia,32,68,0,100
2016,Noviembre,11,11/1/2016,Iraq,0,2,0,2
2016,Noviembre,11,11/1/2016,Irán,1,19,0,20
2016,Noviembre,11,11/1/2016,República de Irlanda,165,298,0,463
2016,Noviembre,11,11/1/2016,Islandia,6,14,0,20
2016,Noviembre,11,11/1/2016,Israel,95,548,0,643
2016,Noviembre,11,11/1/2016,Italia,976,2779,0,3755
2016,Noviembre,11,11/1/2016,Jamaica,20,44,0,64
2016,Noviembre,11,11/1/2016,Japón,159,603,0,762
2016,Noviembre,11,11/1/2016,Jordania,5,8,0,13
2016,Noviembre,11,11/1/2016,Kazajistán,6,3,0,9
2016,Noviembre,11,11/1/2016,Kenia,11,18,0,29
2016,Noviembre,11,11/1/2016,Kirguistán,1,1,0,2
2016,Noviembre,11,11/1/2016,Kuwait,0,2,0,2
2016,Noviembre,11,11/1/2016,República de Kosovo,0,1,0,1
2016,Noviembre,11,11/1/2016,Lesoto,1,1,0,2
2016,Noviembre,11,11/1/2016,Letonia,29,36,0,65
2016,Noviembre,11,11/1/2016,Lituania,35,34,0,69
2016,Noviembre,11,11/1/2016,Líbano,13,30,0,43
2016,Noviembre,11,11/1/2016,Liechtenstein,2,3,0,5
2016,Noviembre,11,11/1/2016,Luxemburgo,5,10,0,15
2016,Noviembre,11,11/1/2016,Macedonia,1,3,0,4
2016,Noviembre,11,11/1/2016,Madagascar,3,0,0,3
2016,Noviembre,11,11/1/2016,Malasia,37,41,0,78
2016,Noviembre,11,11/1/2016,Malawi,1,2,0,3
2016,Noviembre,11,11/1/2016,Malí,0,6,0,6
2016,Noviembre,11,11/1/2016,Malta,2,7,0,9
2016,Noviembre,11,11/1/2016,Marruecos,6,13,0,19
2016,Noviembre,11,11/1/2016,Mauricio,1,7,0,8
2016,Noviembre,11,11/1/2016,México,4805,8996,0,13801
2016,Noviembre,11,11/1/2016,República de Moldavia,3,1,0,4
2016,Noviembre,11,11/1/2016,Mónaco,0,2,0,2
2016,Noviembre,11,11/1/2016,Mongolia,1,1,0,2
2016,Noviembre,11,11/1/2016,Montenegro,1,5,0,6
2016,Noviembre,11,11/1/2016,Mozambique,1,5,0,6
2016,Noviembre,11,11/1/2016,Myanmar,1,15,0,16
2016,Noviembre,11,11/1/2016,Nepal,2,12,0,14
2016,Noviembre,11,11/1/2016,Nicaragua,195,126,0,321
2016,Noviembre,11,11/1/2016,Nigeria,7,23,0,30
2016,Noviembre,11,11/1/2016,Noruega,131,221,0,352
2016,Noviembre,11,11/1/2016,Nueva Zelanda,84,142,0,226
2016,Noviembre,11,11/1/2016,Omán,0,2,0,2
2016,Noviembre,11,11/1/2016,Papúa Nueva Guinea,0,1,0,1
2016,Noviembre,11,11/1/2016,Pakistán,3,13,0,16
2016,Noviembre,11,11/1/2016,Panamá,5522,4955,0,10477
2016,Noviembre,11,11/1/2016,Paraguay,311,367,0,678
2016,Noviembre,11,11/1/2016,Perú,5549,6864,0,12413
2016,Noviembre,11,11/1/2016,Palestina,0,1,0,1
2016,Noviembre,11,11/1/2016,Polonia,224,321,0,545
2016,Noviembre,11,11/1/2016,Portugal,243,568,0,811
2016,Noviembre,11,11/1/2016,Puerto Rico/Territorio de Estados Unidos,0,1,0,1
2016,Noviembre,11,11/1/2016,Qatar,0,2,0,2
2016,Noviembre,11,11/1/2016,Reino Unido de Gran Bretaña e Irlanda del Norte,1166,2613,0,3779
2016,Noviembre,11,11/1/2016,Federación de Rusia,205,308,0,513
2016,Noviembre,11,11/1/2016,República Dominicana,807,1036,0,1843
2016,Noviembre,11,11/1/2016,Rumania,68,95,0,163
2016,Noviembre,11,11/1/2016,Rwanda,0,1,0,1
2016,Noviembre,11,11/1/2016,San Cristóbal y Nevis,2,1,0,3
2016,Noviembre,11,11/1/2016,San Marino,1,1,0,2
2016,Noviembre,11,11/1/2016,San  Vicente y las Granadinas,2,1,0,3
2016,Noviembre,11,11/1/2016,Santa Lucia,2,7,0,9
2016,Diciembre,12,12/1/2016,Barbados,20,15,0,35
2016,Noviembre,11,11/1/2016,Santa Sede/Ciudad del Vaticano,0,2,0,2
2016,Noviembre,11,11/1/2016,Senegal,2,5,0,7
2016,Noviembre,11,11/1/2016,Serbia,9,21,0,30
2016,Noviembre,11,11/1/2016,Seychelles,0,1,0,1
2016,Noviembre,11,11/1/2016,Sierra Leona,0,2,0,2
2016,Noviembre,11,11/1/2016,Singapur,25,47,0,72
2016,Noviembre,11,11/1/2016,República Árabe Siria,0,1,0,1
2016,Noviembre,11,11/1/2016,Sri Lanka,3,9,0,12
2016,Noviembre,11,11/1/2016,Sudáfrica,44,92,0,136
2016,Noviembre,11,11/1/2016,Sudán,0,2,0,2
2016,Noviembre,11,11/1/2016,Suecia,231,345,0,576
2016,Noviembre,11,11/1/2016,Suiza,503,824,0,1327
2016,Noviembre,11,11/1/2016,Surinam,23,27,0,50
2016,Noviembre,11,11/1/2016,Suazilandia,0,1,0,1
2016,Noviembre,11,11/1/2016,Taiwán,66,101,0,167
2016,Noviembre,11,11/1/2016,Tailandia,31,16,0,47
2016,Noviembre,11,11/1/2016,Tanzania,1,16,0,17
2016,Noviembre,11,11/1/2016,Tonga,1,0,0,1
2016,Noviembre,11,11/1/2016,Trinidad y Tobago,32,73,0,105
2016,Noviembre,11,11/1/2016,Túnez,1,11,0,12
2016,Noviembre,11,11/1/2016,Turquía,194,391,0,585
2016,Noviembre,11,11/1/2016,Ucrania,27,47,0,74
2016,Noviembre,11,11/1/2016,Uganda,4,2,0,6
2016,Noviembre,11,11/1/2016,Uruguay,438,606,0,1044
2016,Noviembre,11,11/1/2016,Venezuela,18533,22501,0,41034
2016,Noviembre,11,11/1/2016,Vietnam,10,14,0,24
2016,Noviembre,11,11/1/2016,República Árabe de Yemen,0,1,0,1
2016,Noviembre,11,11/1/2016,Zambia,1,6,0,7
2016,Noviembre,11,11/1/2016,Zimbabue,9,9,0,18
2016,Noviembre,11,11/1/2016,Anguila/Territorio Británico de Ultramar,0,1,0,1
2016,Noviembre,11,11/1/2016,Islas Turcas y Caicos/Territorio Británico de Ultramar,1,0,0,1
2016,Noviembre,11,11/1/2016,Refugiado,0,2,0,2
2016,Noviembre,11,11/1/2016,Desconocido,0,1,0,1
2016,Noviembre,11,11/1/2016,Desconocido,90,174,0,264
2016,Diciembre,12,12/1/2016,Albania,1,4,0,5
2016,Diciembre,12,12/1/2016,Alemania,2310,3623,0,5933
2016,Diciembre,12,12/1/2016,Andorra,3,7,0,10
2016,Diciembre,12,12/1/2016,Angola,0,7,0,7
2016,Diciembre,12,12/1/2016,Antigua y Barbuda,3,13,0,16
2016,Diciembre,12,12/1/2016,Países Bajos,1882,2975,0,4857
2016,Diciembre,12,12/1/2016,Arabia Saudita,0,23,0,23
2016,Diciembre,12,12/1/2016,Argelia,2,10,0,12
2016,Diciembre,12,12/1/2016,Argentina,5742,7292,0,13034
2016,Diciembre,12,12/1/2016,República de Armenia,2,1,0,3
2016,Diciembre,12,12/1/2016,Australia,712,1193,0,1905
2016,Diciembre,12,12/1/2016,Austria,219,353,0,572
2016,Diciembre,12,12/1/2016,Azerbaiyán,3,1,0,4
2016,Diciembre,12,12/1/2016,Bahamas,11,11,0,22
2016,Diciembre,12,12/1/2016,Bahréin,0,3,0,3
2016,Diciembre,12,12/1/2016,Bangladesh,0,4,0,4
2016,Diciembre,12,12/1/2016,República de Belarús,9,8,0,17
2016,Diciembre,12,12/1/2016,Bélgica,330,637,0,967
2016,Diciembre,12,12/1/2016,Belice,4,18,0,22
2016,Diciembre,12,12/1/2016,Bermudas/Territorio Británico de Ultramar,3,3,0,6
2016,Diciembre,12,12/1/2016,Bolivia,1193,1155,0,2348
2016,Diciembre,12,12/1/2016,Bosnia y Herzegovina,7,5,0,12
2016,Diciembre,12,12/1/2016,Botsuana,2,1,0,3
2016,Diciembre,12,12/1/2016,Brasil,7378,7694,0,15072
2016,Diciembre,12,12/1/2016,Brunei Darussalam,0,1,0,1
2016,Diciembre,12,12/1/2016,Bulgaria,33,45,0,78
2016,Diciembre,12,12/1/2016,Burkina Faso,0,1,0,1
2016,Diciembre,12,12/1/2016,Islas Caimán/Territorio Británico de Ultramar,6,29,0,35
2016,Diciembre,12,12/1/2016,Camerún,1,4,0,5
2016,Diciembre,12,12/1/2016,Canadá,2526,3687,0,6213
2016,Diciembre,12,12/1/2016,España,4226,7415,0,11641
2016,Diciembre,12,12/1/2016,República Del Congo,0,1,0,1
2016,Diciembre,12,12/1/2016,República Democrática del Congo,1,5,0,6
2016,Diciembre,12,12/1/2016,República de Corea,323,474,0,797
2016,Diciembre,12,12/1/2016,Costa de Marfil,0,2,0,2
2016,Diciembre,12,12/1/2016,Costa Rica,1892,2040,0,3932
2016,Diciembre,12,12/1/2016,Croacia,21,58,0,79
2016,Diciembre,12,12/1/2016,Cuba,271,623,0,894
2016,Diciembre,12,12/1/2016,República Checa,69,94,0,163
2016,Diciembre,12,12/1/2016,Chile,4129,5366,0,9495
2016,Diciembre,12,12/1/2016,China,384,747,0,1131
2016,Diciembre,12,12/1/2016,Chipre,3,5,0,8
2016,Diciembre,12,12/1/2016,Dinamarca,183,287,0,470
2016,Diciembre,12,12/1/2016,Dominica,2,4,0,6
2016,Diciembre,12,12/1/2016,Ecuador,6744,8649,0,15393
2016,Diciembre,12,12/1/2016,Egipto,11,49,0,60
2016,Diciembre,12,12/1/2016,El Salvador,964,1123,0,2087
2016,Diciembre,12,12/1/2016,Emiratos Árabes,0,15,0,15
2016,Diciembre,12,12/1/2016,Eritrea,0,1,0,1
2016,Diciembre,12,12/1/2016,Eslovaquia,35,44,0,79
2016,Diciembre,12,12/1/2016,Eslovenia,22,36,0,58
2016,Diciembre,12,12/1/2016,Estados Unidos de América,20083,32157,0,52240
2016,Diciembre,12,12/1/2016,Estonia,17,22,0,39
2016,Diciembre,12,12/1/2016,Etiopia,1,9,0,10
2016,Diciembre,12,12/1/2016,Filipinas,43,291,0,334
2016,Diciembre,12,12/1/2016,Finlandia,118,167,0,285
2016,Diciembre,12,12/1/2016,Francia,2525,3961,0,6486
2016,Diciembre,12,12/1/2016,Georgia,4,13,0,17
2016,Diciembre,12,12/1/2016,Ghana,2,13,0,15
2016,Diciembre,12,12/1/2016,Granada,3,5,0,8
2016,Diciembre,12,12/1/2016,Grecia,56,139,0,195
2016,Diciembre,12,12/1/2016,Guatemala,1024,1311,0,2335
2016,Diciembre,12,12/1/2016,Guyana,15,17,0,32
2016,Diciembre,12,12/1/2016,Guinea Ecuatorial,1,1,0,2
2016,Diciembre,12,12/1/2016,Haití,13,20,0,33
2016,Diciembre,12,12/1/2016,Honduras,411,447,0,858
2016,Diciembre,12,12/1/2016,Hong Kong,5,14,0,19
2016,Diciembre,12,12/1/2016,Hungría,48,57,0,105
2016,Diciembre,12,12/1/2016,India,102,489,0,591
2016,Diciembre,12,12/1/2016,Indonesia,14,30,0,44
2016,Diciembre,12,12/1/2016,Irán,16,13,0,29
2016,Diciembre,12,12/1/2016,República de Irlanda,156,284,0,440
2016,Diciembre,12,12/1/2016,Islandia,2,13,0,15
2016,Diciembre,12,12/1/2016,Israel,153,529,0,682
2016,Diciembre,12,12/1/2016,Italia,1317,2752,0,4069
2016,Diciembre,12,12/1/2016,Jamaica,24,59,0,83
2016,Diciembre,12,12/1/2016,Japón,267,489,0,756
2016,Diciembre,12,12/1/2016,Jordania,0,13,0,13
2016,Diciembre,12,12/1/2016,Kazajistán,5,2,0,7
2016,Diciembre,12,12/1/2016,Kenia,3,1,0,4
2016,Diciembre,12,12/1/2016,Kiribati,0,1,0,1
2016,Diciembre,12,12/1/2016,Kirguistán,1,0,0,1
2016,Diciembre,12,12/1/2016,Kuwait,3,3,0,6
2016,Diciembre,12,12/1/2016,República de Kosovo,0,1,0,1
2016,Diciembre,12,12/1/2016,Letonia,14,15,0,29
2016,Diciembre,12,12/1/2016,Lituania,28,30,0,58
2016,Diciembre,12,12/1/2016,Líbano,18,37,0,55
2016,Diciembre,12,12/1/2016,Libia,0,1,0,1
2016,Diciembre,12,12/1/2016,Liechtenstein,0,4,0,4
2016,Diciembre,12,12/1/2016,Luxemburgo,6,13,0,19
2016,Diciembre,12,12/1/2016,Madagascar,1,0,0,1
2016,Diciembre,12,12/1/2016,Malasia,22,31,0,53
2016,Diciembre,12,12/1/2016,Malta,4,12,0,16
2016,Diciembre,12,12/1/2016,Marruecos,12,27,0,39
2016,Diciembre,12,12/1/2016,Mauricio,2,3,0,5
2016,Diciembre,12,12/1/2016,México,5333,8139,0,13472
2016,Diciembre,12,12/1/2016,República de Moldavia,3,1,0,4
2016,Diciembre,12,12/1/2016,Mongolia,1,1,0,2
2016,Diciembre,12,12/1/2016,Montenegro,1,4,0,5
2016,Diciembre,12,12/1/2016,Mozambique,2,2,0,4
2016,Diciembre,12,12/1/2016,Myanmar,0,1,0,1
2016,Diciembre,12,12/1/2016,Namibia,4,0,0,4
2016,Diciembre,12,12/1/2016,Nepal,2,4,0,6
2016,Diciembre,12,12/1/2016,Nicaragua,127,105,0,232
2016,Diciembre,12,12/1/2016,Nigeria,3,9,0,12
2016,Diciembre,12,12/1/2016,Noruega,192,297,0,489
2016,Diciembre,12,12/1/2016,Nueva Zelanda,138,188,0,326
2016,Diciembre,12,12/1/2016,Omán,0,1,0,1
2016,Diciembre,12,12/1/2016,Pakistán,3,12,0,15
2016,Diciembre,12,12/1/2016,Panamá,3677,4308,0,7985
2016,Diciembre,12,12/1/2016,Paraguay,318,297,0,615
2016,Diciembre,12,12/1/2016,Perú,4348,5708,0,10056
2016,Diciembre,12,12/1/2016,Palestina,1,7,0,8
2016,Diciembre,12,12/1/2016,Polonia,165,228,0,393
2016,Diciembre,12,12/1/2016,Portugal,231,471,0,702
2016,Diciembre,12,12/1/2016,Qatar,0,1,0,1
2016,Diciembre,12,12/1/2016,Reino Unido de Gran Bretaña e Irlanda del Norte,1557,3085,0,4642
2016,Diciembre,12,12/1/2016,Federación de Rusia,235,288,0,523
2016,Diciembre,12,12/1/2016,República Dominicana,620,808,0,1428
2016,Diciembre,12,12/1/2016,Rumania,78,108,0,186
2016,Diciembre,12,12/1/2016,San Cristóbal y Nevis,0,4,0,4
2016,Diciembre,12,12/1/2016,San Marino,2,3,0,5
2016,Diciembre,12,12/1/2016,San  Vicente y las Granadinas,2,6,0,8
2016,Diciembre,12,12/1/2016,Santa Lucia,4,5,0,9
2016,Diciembre,12,12/1/2016,Serbia,15,19,0,34
2016,Diciembre,12,12/1/2016,Sierra Leona,0,1,0,1
2016,Diciembre,12,12/1/2016,Singapur,28,38,0,66
2016,Diciembre,12,12/1/2016,República Árabe Siria,3,9,0,12
2016,Diciembre,12,12/1/2016,Somalia,1,0,0,1
2016,Diciembre,12,12/1/2016,Sri Lanka,3,6,0,9
2016,Diciembre,12,12/1/2016,Sudáfrica,58,101,0,159
2016,Diciembre,12,12/1/2016,Sudán,0,1,0,1
2016,Diciembre,12,12/1/2016,Suecia,489,699,0,1188
2016,Diciembre,12,12/1/2016,Suiza,837,1446,0,2283
2016,Diciembre,12,12/1/2016,Surinam,93,122,0,215
2016,Diciembre,12,12/1/2016,Taiwán,64,77,0,141
2016,Diciembre,12,12/1/2016,Tailandia,21,11,0,32
2016,Diciembre,12,12/1/2016,Tanzania,1,0,0,1
2016,Diciembre,12,12/1/2016,Togo,0,1,0,1
2016,Diciembre,12,12/1/2016,Trinidad y Tobago,32,100,0,132
2016,Diciembre,12,12/1/2016,Túnez,0,6,0,6
2016,Diciembre,12,12/1/2016,Turquía,182,342,0,524
2016,Diciembre,12,12/1/2016,Ucrania,36,36,0,72
2016,Diciembre,12,12/1/2016,Uganda,0,1,0,1
2016,Diciembre,12,12/1/2016,Uruguay,423,592,0,1015
2016,Diciembre,12,12/1/2016,Uzbekistán,1,4,0,5
2016,Diciembre,12,12/1/2016,Venezuela,21021,21783,0,42804
2016,Diciembre,12,12/1/2016,Vietnam,2,6,0,8
2016,Diciembre,12,12/1/2016,Islas Vírgenes Británicas/Territorio Británico de Ultramar,2,1,0,3
2016,Diciembre,12,12/1/2016,República Árabe de Yemen,0,4,0,4
2016,Diciembre,12,12/1/2016,Zambia,0,1,0,1
2016,Diciembre,12,12/1/2016,Zimbabue,2,1,0,3
2016,Diciembre,12,12/1/2016,Refugiado,1,6,0,7
2016,Diciembre,12,12/1/2016,Desconocido,65,93,0,158
2017,Enero,1,1/1/2017,Afganistán,0,3,0,3
2017,Enero,1,1/1/2017,Albania,5,8,0,13
2017,Enero,1,1/1/2017,Alemania,2253,3366,0,5619
2017,Enero,1,1/1/2017,Andorra,1,8,0,9
2017,Enero,1,1/1/2017,Angola,1,1,0,2
2017,Enero,1,1/1/2017,Antigua y Barbuda,2,14,0,16
2017,Enero,1,1/1/2017,Países Bajos,1679,2362,0,4041
2017,Enero,1,1/1/2017,Arabia Saudita,0,5,0,5
2017,Enero,1,1/1/2017,Argelia,3,5,0,8
2017,Enero,1,1/1/2017,Argentina,10615,10381,0,20996
2017,Enero,1,1/1/2017,República de Armenia,1,1,0,2
2017,Enero,1,1/1/2017,Australia,668,1031,0,1699
2017,Enero,1,1/1/2017,Austria,243,389,0,632
2017,Enero,1,1/1/2017,Azerbaiyán,2,5,0,7
2017,Enero,1,1/1/2017,Bahamas,9,18,0,27
2017,Enero,1,1/1/2017,Bahréin,1,1,0,2
2017,Enero,1,1/1/2017,Bangladesh,1,2,0,3
2017,Enero,1,1/1/2017,Barbados,7,20,0,27
2017,Enero,1,1/1/2017,República de Belarús,11,17,0,28
2017,Enero,1,1/1/2017,Bélgica,361,551,0,912
2017,Enero,1,1/1/2017,Belice,5,10,0,15
2017,Enero,1,1/1/2017,Benín,4,1,0,5
2017,Enero,1,1/1/2017,Bermudas/Territorio Británico de Ultramar,0,3,0,3
2017,Enero,1,1/1/2017,Bolivia,927,970,0,1897
2017,Enero,1,1/1/2017,Bosnia y Herzegovina,0,3,0,3
2017,Enero,1,1/1/2017,Botsuana,0,1,0,1
2017,Enero,1,1/1/2017,Brasil,8382,8507,0,16889
2017,Enero,1,1/1/2017,Brunei Darussalam,1,0,0,1
2017,Enero,1,1/1/2017,Bulgaria,43,39,0,82
2017,Enero,1,1/1/2017,Islas Caimán/Territorio Británico de Ultramar,2,5,0,7
2017,Enero,1,1/1/2017,Camerún,1,4,0,5
2017,Enero,1,1/1/2017,Canadá,2558,3568,0,6126
2017,Enero,1,1/1/2017,España,3469,7142,0,10611
2017,Enero,1,1/1/2017,República Del Congo,0,1,0,1
2017,Enero,1,1/1/2017,República Democrática del Congo,1,8,0,9
2017,Enero,1,1/1/2017,República de Corea,416,595,0,1011
2017,Enero,1,1/1/2017,Costa de Marfil,0,1,0,1
2017,Enero,1,1/1/2017,Costa Rica,1747,1851,0,3598
2017,Enero,1,1/1/2017,Croacia,28,75,0,103
2017,Enero,1,1/1/2017,Cuba,265,601,0,866
2017,Enero,1,1/1/2017,República Checa,63,109,0,172
2017,Enero,1,1/1/2017,Chile,5451,6002,0,11453
2017,Enero,1,1/1/2017,China,394,614,0,1008
2017,Enero,1,1/1/2017,Chipre,5,10,0,15
2017,Enero,1,1/1/2017,Dinamarca,189,328,0,517
2017,Enero,1,1/1/2017,República de Yibuti,2,0,0,2
2017,Enero,1,1/1/2017,Dominica,4,8,0,12
2017,Enero,1,1/1/2017,Ecuador,4356,6411,0,10767
2017,Enero,1,1/1/2017,Egipto,3,17,0,20
2017,Enero,1,1/1/2017,El Salvador,1009,1127,0,2136
2017,Enero,1,1/1/2017,Emiratos Árabes,2,4,0,6
2017,Enero,1,1/1/2017,Eslovaquia,63,76,0,139
2017,Enero,1,1/1/2017,Eslovenia,24,53,0,77
2017,Enero,1,1/1/2017,Estados Unidos de América,12163,21770,0,33933
2017,Enero,1,1/1/2017,Estonia,20,24,0,44
2017,Enero,1,1/1/2017,Etiopia,1,5,0,6
2017,Enero,1,1/1/2017,Filipinas,46,143,0,189
2017,Enero,1,1/1/2017,Finlandia,99,129,0,228
2017,Enero,1,1/1/2017,Francia,2724,4146,0,6870
2017,Enero,1,1/1/2017,Gambia,1,0,0,1
2017,Enero,1,1/1/2017,Georgia,3,6,0,9
2017,Enero,1,1/1/2017,Ghana,4,8,0,12
2017,Enero,1,1/1/2017,Granada,2,4,0,6
2017,Enero,1,1/1/2017,Grecia,33,102,0,135
2017,Enero,1,1/1/2017,Guatemala,523,1000,0,1523
2017,Enero,1,1/1/2017,Guyana,12,16,0,28
2017,Enero,1,1/1/2017,Guinea,0,1,0,1
2017,Enero,1,1/1/2017,Guinea Ecuatorial,2,0,0,2
2017,Enero,1,1/1/2017,Guam/Territorio no incorporado de Estados Unidos,1,0,0,1
2017,Enero,1,1/1/2017,Haití,12,26,0,38
2017,Enero,1,1/1/2017,Honduras,342,403,0,745
2017,Enero,1,1/1/2017,Hong Kong,6,1,0,7
2017,Enero,1,1/1/2017,Hungría,49,72,0,121
2017,Enero,1,1/1/2017,India,91,538,0,629
2017,Enero,1,1/1/2017,Indonesia,25,30,0,55
2017,Enero,1,1/1/2017,Iraq,1,2,0,3
2017,Enero,1,1/1/2017,Irán,9,9,0,18
2017,Enero,1,1/1/2017,República de Irlanda,150,297,0,447
2017,Enero,1,1/1/2017,Islandia,7,8,0,15
2017,Enero,1,1/1/2017,Israel,174,627,0,801
2017,Enero,1,1/1/2017,Italia,1167,2928,0,4095
2017,Enero,1,1/1/2017,Jamaica,22,40,0,62
2017,Enero,1,1/1/2017,Japón,196,506,0,702
2017,Enero,1,1/1/2017,Jordania,2,2,0,4
2017,Enero,1,1/1/2017,Kazajistán,2,10,0,12
2017,Enero,1,1/1/2017,Kenia,7,7,0,14
2017,Enero,1,1/1/2017,Kiribati,0,2,0,2
2017,Enero,1,1/1/2017,Kirguistán,0,1,0,1
2017,Enero,1,1/1/2017,Kuwait,0,2,0,2
2017,Enero,1,1/1/2017,República de Kosovo,0,4,0,4
2017,Enero,1,1/1/2017,Letonia,7,26,0,33
2017,Enero,1,1/1/2017,Lituania,32,36,0,68
2017,Enero,1,1/1/2017,Líbano,23,42,0,65
2017,Enero,1,1/1/2017,Liberia,2,0,0,2
2017,Enero,1,1/1/2017,Libia,0,1,0,1
2017,Enero,1,1/1/2017,Liechtenstein,5,5,0,10
2017,Enero,1,1/1/2017,Luxemburgo,12,15,0,27
2017,Enero,1,1/1/2017,Macedonia,1,5,0,6
2017,Enero,1,1/1/2017,Madagascar,1,0,0,1
2017,Enero,1,1/1/2017,Malasia,14,30,0,44
2017,Enero,1,1/1/2017,Malawi,3,1,0,4
2017,Enero,1,1/1/2017,Malta,6,12,0,18
2017,Enero,1,1/1/2017,Marruecos,7,16,0,23
2017,Enero,1,1/1/2017,Mauricio,3,6,0,9
2017,Enero,1,1/1/2017,México,4505,7568,0,12073
2017,Enero,1,1/1/2017,República de Moldavia,2,3,0,5
2017,Enero,1,1/1/2017,Mónaco,2,2,0,4
2017,Enero,1,1/1/2017,Mongolia,3,0,0,3
2017,Enero,1,1/1/2017,Montenegro,0,2,0,2
2017,Enero,1,1/1/2017,Mozambique,0,1,0,1
2017,Enero,1,1/1/2017,Myanmar,0,6,0,6
2017,Enero,1,1/1/2017,Namibia,0,2,0,2
2017,Enero,1,1/1/2017,Nepal,1,2,0,3
2017,Enero,1,1/1/2017,Nicaragua,126,163,0,289
2017,Enero,1,1/1/2017,Nigeria,6,8,0,14
2017,Enero,1,1/1/2017,Noruega,168,257,0,425
2017,Enero,1,1/1/2017,Nueva Zelanda,81,125,0,206
2017,Enero,1,1/1/2017,Pakistán,7,21,0,28
2017,Enero,1,1/1/2017,Panamá,4078,3832,0,7910
2017,Enero,1,1/1/2017,Paraguay,364,365,0,729
2017,Enero,1,1/1/2017,Perú,4805,5846,0,10651
2017,Enero,1,1/1/2017,Palestina,0,1,0,1
2017,Enero,1,1/1/2017,Polonia,217,300,0,517
2017,Enero,1,1/1/2017,Portugal,311,642,0,953
2017,Enero,1,1/1/2017,Puerto Rico/Territorio de Estados Unidos,0,1,0,1
2017,Enero,1,1/1/2017,Qatar,0,3,0,3
2017,Enero,1,1/1/2017,Reino Unido de Gran Bretaña e Irlanda del Norte,1498,2865,0,4363
2017,Enero,1,1/1/2017,República CentroÁfricana,5,0,0,5
2017,Enero,1,1/1/2017,Federación de Rusia,339,390,0,729
2017,Enero,1,1/1/2017,República Dominicana,571,846,0,1417
2017,Enero,1,1/1/2017,Rumania,77,114,0,191
2017,Enero,1,1/1/2017,Rwanda,0,2,0,2
2017,Enero,1,1/1/2017,San Cristóbal y Nevis,1,7,0,8
2017,Enero,1,1/1/2017,San  Vicente y las Granadinas,0,5,0,5
2017,Enero,1,1/1/2017,Santa Lucia,5,4,0,9
2017,Enero,1,1/1/2017,Santa Sede/Ciudad del Vaticano,0,2,0,2
2017,Enero,1,1/1/2017,Senegal,0,1,0,1
2017,Enero,1,1/1/2017,Serbia,8,31,0,39
2017,Enero,1,1/1/2017,Singapur,25,26,0,51
2017,Enero,1,1/1/2017,República Árabe Siria,1,2,0,3
2017,Enero,1,1/1/2017,Sri Lanka,3,6,0,9
2017,Enero,1,1/1/2017,Sudáfrica,57,78,0,135
2017,Enero,1,1/1/2017,Suecia,478,609,0,1087
2017,Enero,1,1/1/2017,Suiza,750,1153,0,1903
2017,Enero,1,1/1/2017,Surinam,10,25,0,35
2017,Enero,1,1/1/2017,Taiwán,75,98,0,173
2017,Enero,1,1/1/2017,Tailandia,15,7,0,22
2017,Enero,1,1/1/2017,Tanzania,2,2,0,4
2017,Enero,1,1/1/2017,República Democrática de Timor Oriental,0,1,0,1
2017,Enero,1,1/1/2017,Trinidad y Tobago,39,100,0,139
2017,Enero,1,1/1/2017,Túnez,1,7,0,8
2017,Enero,1,1/1/2017,Turquía,213,349,0,562
2017,Enero,1,1/1/2017,Ucrania,39,43,0,82
2017,Enero,1,1/1/2017,Uganda,2,1,0,3
2017,Enero,1,1/1/2017,Uruguay,534,636,0,1170
2017,Enero,1,1/1/2017,Uzbekistán,0,1,0,1
2017,Enero,1,1/1/2017,Venezuela,20895,26229,0,47124
2017,Enero,1,1/1/2017,Vietnam,6,13,0,19
2017,Enero,1,1/1/2017,Islas Vírgenes Británicas/Territorio Británico de Ultramar,2,1,0,3
2017,Enero,1,1/1/2017,República Árabe de Yemen,0,1,0,1
2017,Enero,1,1/1/2017,Zambia,2,1,0,3
2017,Enero,1,1/1/2017,Zimbabue,1,5,0,6
2017,Enero,1,1/1/2017,Islas Turcas y Caicos/Territorio Británico de Ultramar,0,1,0,1
2017,Enero,1,1/1/2017,Refugiado Otro,0,1,0,1
2017,Enero,1,1/1/2017,Refugiado,0,3,0,3
2017,Enero,1,1/1/2017,Desconocido,59,135,0,194
2017,Febrero,2,2/1/2017,Afganistán,0,2,0,2
2017,Febrero,2,2/1/2017,Albania,2,7,0,9
2017,Febrero,2,2/1/2017,Alemania,2763,3640,0,6403
2017,Febrero,2,2/1/2017,Andorra,7,18,0,25
2017,Febrero,2,2/1/2017,Angola,2,5,0,7
2017,Febrero,2,2/1/2017,Antigua y Barbuda,2,10,0,12
2017,Febrero,2,2/1/2017,Países Bajos,1661,2437,0,4098
2017,Febrero,2,2/1/2017,Arabia Saudita,0,4,0,4
2017,Febrero,2,2/1/2017,Argelia,3,3,0,6
2017,Febrero,2,2/1/2017,Argentina,8281,9295,0,17576
2017,Febrero,2,2/1/2017,República de Armenia,3,6,0,9
2017,Febrero,2,2/1/2017,Australia,428,731,0,1159
2017,Febrero,2,2/1/2017,Austria,306,460,0,766
2017,Febrero,2,2/1/2017,Azerbaiyán,0,5,0,5
2017,Febrero,2,2/1/2017,Bahamas,8,31,0,39
2017,Febrero,2,2/1/2017,Bahréin,0,2,0,2
2017,Febrero,2,2/1/2017,Bangladesh,0,4,0,4
2017,Febrero,2,2/1/2017,Barbados,13,18,0,31
2017,Febrero,2,2/1/2017,República de Belarús,5,22,0,27
2017,Febrero,2,2/1/2017,Bélgica,407,616,0,1023
2017,Febrero,2,2/1/2017,Belice,12,13,0,25
2017,Febrero,2,2/1/2017,Benín,0,1,0,1
2017,Febrero,2,2/1/2017,Bermudas/Territorio Británico de Ultramar,0,3,0,3
2017,Febrero,2,2/1/2017,Bolivia,753,802,0,1555
2017,Febrero,2,2/1/2017,Bosnia y Herzegovina,3,1,0,4
2017,Febrero,2,2/1/2017,Botsuana,1,0,0,1
2017,Febrero,2,2/1/2017,Brasil,8200,8481,0,16681
2017,Febrero,2,2/1/2017,Bulgaria,55,45,0,100
2017,Febrero,2,2/1/2017,Burkina Faso,1,1,0,2
2017,Febrero,2,2/1/2017,Burundi,1,5,0,6
2017,Febrero,2,2/1/2017,Cabo Verde,0,2,0,2
2017,Febrero,2,2/1/2017,Islas Caimán/Territorio Británico de Ultramar,1,7,0,8
2017,Febrero,2,2/1/2017,Camboya,0,3,0,3
2017,Febrero,2,2/1/2017,Camerún,3,2,0,5
2017,Febrero,2,2/1/2017,Canadá,2584,3751,0,6335
2017,Febrero,2,2/1/2017,Chad,2,1,0,3
2017,Febrero,2,2/1/2017,España,2803,6291,0,9094
2017,Febrero,2,2/1/2017,República Democrática del Congo,0,4,0,4
2017,Febrero,2,2/1/2017,República de Corea,358,539,0,897
2017,Febrero,2,2/1/2017,Costa de Marfil,1,9,0,10
2017,Febrero,2,2/1/2017,Costa Rica,1318,1681,0,2999
2017,Febrero,2,2/1/2017,Croacia,22,89,0,111
2017,Febrero,2,2/1/2017,Cuba,186,459,0,645
2017,Febrero,2,2/1/2017,República Checa,94,182,0,276
2017,Febrero,2,2/1/2017,Chile,7700,7898,0,15598
2017,Febrero,2,2/1/2017,China,511,961,0,1472
2017,Febrero,2,2/1/2017,Chipre,4,5,0,9
2017,Febrero,2,2/1/2017,Dinamarca,220,345,0,565
2017,Febrero,2,2/1/2017,Dominica,2,5,0,7
2017,Febrero,2,2/1/2017,Ecuador,5185,6723,0,11908
2017,Febrero,2,2/1/2017,Egipto,8,38,0,46
2017,Febrero,2,2/1/2017,El Salvador,939,1150,0,2089
2017,Febrero,2,2/1/2017,Emiratos Árabes,1,4,0,5
2017,Febrero,2,2/1/2017,Eritrea,0,1,0,1
2017,Febrero,2,2/1/2017,Eslovaquia,29,44,0,73
2017,Febrero,2,2/1/2017,Eslovenia,58,90,0,148
2017,Febrero,2,2/1/2017,Estados Unidos de América,14765,25458,0,40223
2017,Febrero,2,2/1/2017,Estonia,62,103,0,165
2017,Febrero,2,2/1/2017,Islas Fiji,0,1,0,1
2017,Febrero,2,2/1/2017,Filipinas,52,319,0,371
2017,Febrero,2,2/1/2017,Finlandia,93,129,0,222
2017,Febrero,2,2/1/2017,Francia,2892,4185,0,7077
2017,Febrero,2,2/1/2017,Georgia,13,13,0,26
2017,Febrero,2,2/1/2017,Ghana,3,10,0,13
2017,Febrero,2,2/1/2017,Granada,3,7,0,10
2017,Febrero,2,2/1/2017,Grecia,39,92,0,131
2017,Febrero,2,2/1/2017,Guatemala,597,1105,0,1702
2017,Febrero,2,2/1/2017,Guyana,7,19,0,26
2017,Febrero,2,2/1/2017,Guinea,0,3,0,3
2017,Febrero,2,2/1/2017,Guinea Ecuatorial,2,2,0,4
2017,Febrero,2,2/1/2017,Haití,9,21,0,30
2017,Febrero,2,2/1/2017,Honduras,278,350,0,628
2017,Febrero,2,2/1/2017,Hong Kong,6,7,0,13
2017,Febrero,2,2/1/2017,Hungría,59,98,0,157
2017,Febrero,2,2/1/2017,India,63,479,0,542
2017,Febrero,2,2/1/2017,Indonesia,19,40,0,59
2017,Febrero,2,2/1/2017,Iraq,1,2,0,3
2017,Febrero,2,2/1/2017,Irán,7,15,0,22
2017,Febrero,2,2/1/2017,República de Irlanda,143,271,0,414
2017,Febrero,2,2/1/2017,Islandia,4,19,0,23
2017,Febrero,2,2/1/2017,Israel,226,724,0,950
2017,Febrero,2,2/1/2017,Italia,1160,2841,0,4001
2017,Febrero,2,2/1/2017,Jamaica,27,54,0,81
2017,Febrero,2,2/1/2017,Japón,230,632,0,862
2017,Febrero,2,2/1/2017,Jordania,2,8,0,10
2017,Febrero,2,2/1/2017,Kazajistán,9,9,0,18
2017,Febrero,2,2/1/2017,Kenia,6,13,0,19
2017,Febrero,2,2/1/2017,Kiribati,0,1,0,1
2017,Febrero,2,2/1/2017,Kuwait,0,4,0,4
2017,Febrero,2,2/1/2017,República de Kosovo,2,0,0,2
2017,Febrero,2,2/1/2017,Letonia,7,25,0,32
2017,Febrero,2,2/1/2017,Lituania,35,49,0,84
2017,Febrero,2,2/1/2017,Líbano,10,29,0,39
2017,Febrero,2,2/1/2017,Libia,2,1,0,3
2017,Febrero,2,2/1/2017,Liechtenstein,2,2,0,4
2017,Febrero,2,2/1/2017,Luxemburgo,13,18,0,31
2017,Febrero,2,2/1/2017,Macedonia,2,0,0,2
2017,Febrero,2,2/1/2017,Madagascar,1,0,0,1
2017,Febrero,2,2/1/2017,Malasia,10,31,0,41
2017,Febrero,2,2/1/2017,Malí,3,2,0,5
2017,Febrero,2,2/1/2017,Malta,10,14,0,24
2017,Febrero,2,2/1/2017,Marruecos,14,20,0,34
2017,Febrero,2,2/1/2017,Mauricio,0,2,0,2
2017,Febrero,2,2/1/2017,Mauritania,0,2,0,2
2017,Febrero,2,2/1/2017,México,4072,8008,0,12080
2017,Febrero,2,2/1/2017,República de Moldavia,4,0,0,4
2017,Febrero,2,2/1/2017,Mónaco,4,3,0,7
2017,Febrero,2,2/1/2017,Mongolia,4,1,0,5
2017,Febrero,2,2/1/2017,Mozambique,2,0,0,2
2017,Febrero,2,2/1/2017,Namibia,1,2,0,3
2017,Febrero,2,2/1/2017,Nepal,1,3,0,4
2017,Febrero,2,2/1/2017,Nicaragua,100,127,0,227
2017,Febrero,2,2/1/2017,Nigeria,2,26,0,28
2017,Febrero,2,2/1/2017,Níger,4,0,0,4
2017,Febrero,2,2/1/2017,Noruega,170,239,0,409
2017,Febrero,2,2/1/2017,Nueva Zelanda,84,139,0,223
2017,Febrero,2,2/1/2017,Pakistán,3,15,0,18
2017,Febrero,2,2/1/2017,Panamá,5669,5047,0,10716
2017,Febrero,2,2/1/2017,Paraguay,274,274,0,548
2017,Febrero,2,2/1/2017,Perú,5863,6716,0,12579
2017,Febrero,2,2/1/2017,Palestina,0,6,0,6
2017,Febrero,2,2/1/2017,Polonia,185,302,0,487
2017,Febrero,2,2/1/2017,Portugal,193,506,0,699
2017,Febrero,2,2/1/2017,Reino Unido de Gran Bretaña e Irlanda del Norte,1504,2663,0,4167
2017,Febrero,2,2/1/2017,República CentroÁfricana,0,1,0,1
2017,Febrero,2,2/1/2017,Federación de Rusia,195,283,0,478
2017,Febrero,2,2/1/2017,República Dominicana,609,830,0,1439
2017,Febrero,2,2/1/2017,Rumania,72,111,0,183
2017,Febrero,2,2/1/2017,Rwanda,1,0,0,1
2017,Febrero,2,2/1/2017,San Cristóbal y Nevis,3,7,0,10
2017,Febrero,2,2/1/2017,Samoa Occidental,1,0,0,1
2017,Febrero,2,2/1/2017,San Marino,0,2,0,2
2017,Febrero,2,2/1/2017,San  Vicente y las Granadinas,1,3,0,4
2017,Febrero,2,2/1/2017,Santa Lucia,4,5,0,9
2017,Febrero,2,2/1/2017,Santa Sede/Ciudad del Vaticano,0,1,0,1
2017,Febrero,2,2/1/2017,Senegal,0,2,0,2
2017,Febrero,2,2/1/2017,Serbia,5,29,0,34
2017,Febrero,2,2/1/2017,Singapur,21,20,0,41
2017,Febrero,2,2/1/2017,República Árabe Siria,2,4,0,6
2017,Febrero,2,2/1/2017,Sri Lanka,1,1,0,2
2017,Febrero,2,2/1/2017,Sudáfrica,45,65,0,110
2017,Febrero,2,2/1/2017,Sudán,0,1,0,1
2017,Febrero,2,2/1/2017,Suecia,359,523,0,882
2017,Febrero,2,2/1/2017,Suiza,720,1094,0,1814
2017,Febrero,2,2/1/2017,Surinam,19,24,0,43
2017,Febrero,2,2/1/2017,Taiwán,97,97,0,194
2017,Febrero,2,2/1/2017,República de Tayikistán,0,1,0,1
2017,Febrero,2,2/1/2017,Tailandia,12,8,0,20
2017,Febrero,2,2/1/2017,Tanzania,0,2,0,2
2017,Febrero,2,2/1/2017,Trinidad y Tobago,48,98,0,146
2017,Febrero,2,2/1/2017,Túnez,10,9,0,19
2017,Febrero,2,2/1/2017,Turquía,189,343,0,532
2017,Febrero,2,2/1/2017,Ucrania,19,47,0,66
2017,Febrero,2,2/1/2017,Uganda,0,2,0,2
2017,Febrero,2,2/1/2017,Uruguay,466,542,0,1008
2017,Febrero,2,2/1/2017,Uzbekistán,2,0,0,2
2017,Febrero,2,2/1/2017,Venezuela,17603,22350,0,39953
2017,Febrero,2,2/1/2017,Vietnam,4,23,0,27
2017,Febrero,2,2/1/2017,Islas Vírgenes Británicas/Territorio Británico de Ultramar,2,0,0,2
2017,Febrero,2,2/1/2017,Zimbabue,1,0,0,1
2017,Febrero,2,2/1/2017,Islas Turcas y Caicos/Territorio Británico de Ultramar,1,0,0,1
2017,Febrero,2,2/1/2017,Refugiado,5,7,0,12
2017,Febrero,2,2/1/2017,Desconocido,79,119,0,198
2017,Marzo,3,3/1/2017,Albania,2,3,0,5
2017,Marzo,3,3/1/2017,Alemania,2717,3920,0,6637
2017,Marzo,3,3/1/2017,Andorra,1,12,0,13
2017,Marzo,3,3/1/2017,Antigua y Barbuda,1,4,0,5
2017,Marzo,3,3/1/2017,Países Bajos,1598,2337,0,3935
2017,Marzo,3,3/1/2017,Arabia Saudita,2,11,0,13
2017,Marzo,3,3/1/2017,Argelia,0,7,0,7
2017,Marzo,3,3/1/2017,Argentina,9626,10495,0,20121
2017,Marzo,3,3/1/2017,República de Armenia,1,5,0,6
2017,Marzo,3,3/1/2017,Australia,403,784,0,1187
2017,Marzo,3,3/1/2017,Austria,186,327,0,513
2017,Marzo,3,3/1/2017,Azerbaiyán,3,7,0,10
2017,Marzo,3,3/1/2017,Bahamas,13,14,0,27
2017,Marzo,3,3/1/2017,Bahréin,0,1,0,1
2017,Marzo,3,3/1/2017,Bangladesh,4,4,0,8
2017,Marzo,3,3/1/2017,Barbados,7,10,0,17
2017,Marzo,3,3/1/2017,República de Belarús,8,8,0,16
2017,Marzo,3,3/1/2017,Bélgica,352,630,0,982
2017,Marzo,3,3/1/2017,Belice,4,13,0,17
2017,Marzo,3,3/1/2017,Benín,2,0,0,2
2017,Marzo,3,3/1/2017,Bermudas/Territorio Británico de Ultramar,0,4,0,4
2017,Marzo,3,3/1/2017,Bolivia,539,706,0,1245
2017,Marzo,3,3/1/2017,Bosnia y Herzegovina,1,1,0,2
2017,Marzo,3,3/1/2017,Botsuana,0,2,0,2
2017,Marzo,3,3/1/2017,Brasil,7597,8435,0,16032
2017,Marzo,3,3/1/2017,Bulgaria,46,41,0,87
2017,Marzo,3,3/1/2017,Burkina Faso,0,1,0,1
2017,Marzo,3,3/1/2017,Burundi,0,1,0,1
2017,Marzo,3,3/1/2017,Bután,1,1,0,2
2017,Marzo,3,3/1/2017,Islas Caimán/Territorio Británico de Ultramar,1,2,0,3
2017,Marzo,3,3/1/2017,Camboya,0,1,0,1
2017,Marzo,3,3/1/2017,Camerún,2,3,0,5
2017,Marzo,3,3/1/2017,Canadá,2454,3530,0,5984
2017,Marzo,3,3/1/2017,Chad,0,2,0,2
2017,Marzo,3,3/1/2017,España,3101,6850,0,9951
2017,Marzo,3,3/1/2017,República Del Congo,0,2,0,2
2017,Marzo,3,3/1/2017,República Democrática del Congo,6,14,0,20
2017,Marzo,3,3/1/2017,República de Corea,264,582,0,846
2017,Marzo,3,3/1/2017,Costa de Marfil,0,3,0,3
2017,Marzo,3,3/1/2017,Costa Rica,1407,1871,0,3278
2017,Marzo,3,3/1/2017,Croacia,26,86,0,112
2017,Marzo,3,3/1/2017,Cuba,205,383,0,588
2017,Marzo,3,3/1/2017,República Checa,106,154,0,260
2017,Marzo,3,3/1/2017,Chile,5115,6257,0,11372
2017,Marzo,3,3/1/2017,China,504,1103,0,1607
2017,Marzo,3,3/1/2017,Chipre,7,6,0,13
2017,Marzo,3,3/1/2017,Dinamarca,173,433,0,606
2017,Marzo,3,3/1/2017,Dominica,0,5,0,5
2017,Marzo,3,3/1/2017,Ecuador,5771,7558,0,13329
2017,Marzo,3,3/1/2017,Egipto,10,36,0,46
2017,Marzo,3,3/1/2017,El Salvador,951,1215,0,2166
2017,Marzo,3,3/1/2017,Emiratos Árabes,5,16,0,21
2017,Marzo,3,3/1/2017,Eritrea,0,1,0,1
2017,Marzo,3,3/1/2017,Eslovaquia,42,59,0,101
2017,Marzo,3,3/1/2017,Eslovenia,23,41,0,64
2017,Marzo,3,3/1/2017,Estados Unidos de América,16447,28013,0,44460
2017,Marzo,3,3/1/2017,Estonia,13,25,0,38
2017,Marzo,3,3/1/2017,Etiopia,2,5,0,7
2017,Marzo,3,3/1/2017,Filipinas,39,254,0,293
2017,Marzo,3,3/1/2017,Finlandia,65,112,0,177
2017,Marzo,3,3/1/2017,Francia,2395,3720,0,6115
2017,Marzo,3,3/1/2017,Georgia,1,4,0,5
2017,Marzo,3,3/1/2017,Ghana,1,11,0,12
2017,Marzo,3,3/1/2017,Granada,0,4,0,4
2017,Marzo,3,3/1/2017,Grecia,36,114,0,150
2017,Marzo,3,3/1/2017,Guatemala,630,1220,0,1850
2017,Marzo,3,3/1/2017,Guyana,15,22,0,37
2017,Marzo,3,3/1/2017,Haití,17,25,0,42
2017,Marzo,3,3/1/2017,Honduras,300,417,0,717
2017,Marzo,3,3/1/2017,Hong Kong,2,5,0,7
2017,Marzo,3,3/1/2017,Hungría,41,59,0,100
2017,Marzo,3,3/1/2017,India,160,682,0,842
2017,Marzo,3,3/1/2017,Indonesia,17,42,0,59
2017,Marzo,3,3/1/2017,Iraq,0,3,0,3
2017,Marzo,3,3/1/2017,Irán,4,16,0,20
2017,Marzo,3,3/1/2017,República de Irlanda,169,276,0,445
2017,Marzo,3,3/1/2017,Islandia,13,24,0,37
2017,Marzo,3,3/1/2017,Israel,489,1146,0,1635
2017,Marzo,3,3/1/2017,Italia,922,2465,0,3387
2017,Marzo,3,3/1/2017,Jamaica,31,24,0,55
2017,Marzo,3,3/1/2017,Islas Salomón,1,0,0,1
2017,Marzo,3,3/1/2017,Japón,234,662,0,896
2017,Marzo,3,3/1/2017,Jordania,5,8,0,13
2017,Marzo,3,3/1/2017,Kazajistán,6,10,0,16
2017,Marzo,3,3/1/2017,Kenia,10,7,0,17
2017,Marzo,3,3/1/2017,Kuwait,4,4,0,8
2017,Marzo,3,3/1/2017,República de Kosovo,1,0,0,1
2017,Marzo,3,3/1/2017,Letonia,22,39,0,61
2017,Marzo,3,3/1/2017,Lituania,34,37,0,71
2017,Marzo,3,3/1/2017,Líbano,25,32,0,57
2017,Marzo,3,3/1/2017,Libia,0,1,0,1
2017,Marzo,3,3/1/2017,Liechtenstein,4,5,0,9
2017,Marzo,3,3/1/2017,Luxemburgo,9,22,0,31
2017,Marzo,3,3/1/2017,Macedonia,2,2,0,4
2017,Marzo,3,3/1/2017,Madagascar,2,0,0,2
2017,Marzo,3,3/1/2017,Malasia,24,35,0,59
2017,Marzo,3,3/1/2017,Malawi,1,2,0,3
2017,Marzo,3,3/1/2017,Malí,4,0,0,4
2017,Marzo,3,3/1/2017,Malta,2,6,0,8
2017,Marzo,3,3/1/2017,Marruecos,4,14,0,18
2017,Marzo,3,3/1/2017,Mauricio,0,4,0,4
2017,Marzo,3,3/1/2017,México,4362,8486,0,12848
2017,Marzo,3,3/1/2017,República de Moldavia,3,1,0,4
2017,Marzo,3,3/1/2017,Mónaco,0,1,0,1
2017,Marzo,3,3/1/2017,Mongolia,2,6,0,8
2017,Marzo,3,3/1/2017,Montenegro,0,2,0,2
2017,Marzo,3,3/1/2017,Mozambique,1,1,0,2
2017,Marzo,3,3/1/2017,Myanmar,0,1,0,1
2017,Marzo,3,3/1/2017,Nepal,0,3,0,3
2017,Marzo,3,3/1/2017,Nicaragua,106,137,0,243
2017,Marzo,3,3/1/2017,Nigeria,10,10,0,20
2017,Marzo,3,3/1/2017,Noruega,176,275,0,451
2017,Marzo,3,3/1/2017,Nueva Zelanda,79,130,0,209
2017,Marzo,3,3/1/2017,Omán,0,4,0,4
2017,Marzo,3,3/1/2017,Pakistán,5,15,0,20
2017,Marzo,3,3/1/2017,Panamá,2573,3039,0,5612
2017,Marzo,3,3/1/2017,Paraguay,294,277,0,571
2017,Marzo,3,3/1/2017,Perú,5303,6437,0,11740
2017,Marzo,3,3/1/2017,Palestina,3,3,0,6
2017,Marzo,3,3/1/2017,Polonia,162,272,0,434
2017,Marzo,3,3/1/2017,Portugal,236,606,0,842
2017,Marzo,3,3/1/2017,Qatar,0,1,0,1
2017,Marzo,3,3/1/2017,Reino Unido de Gran Bretaña e Irlanda del Norte,1474,2916,0,4390
2017,Marzo,3,3/1/2017,Federación de Rusia,195,253,0,448
2017,Marzo,3,3/1/2017,República Dominicana,505,772,0,1277
2017,Marzo,3,3/1/2017,Rumania,61,108,0,169
2017,Marzo,3,3/1/2017,Rwanda,1,0,0,1
2017,Marzo,3,3/1/2017,San Cristóbal y Nevis,0,2,0,2
2017,Marzo,3,3/1/2017,Samoa Occidental,0,1,0,1
2017,Marzo,3,3/1/2017,San  Vicente y las Granadinas,1,2,0,3
2017,Marzo,3,3/1/2017,Santa Lucia,4,4,0,8
2017,Marzo,3,3/1/2017,Santo Tomé y Príncipe,1,1,0,2
2017,Marzo,3,3/1/2017,Senegal,1,2,0,3
2017,Marzo,3,3/1/2017,Serbia,16,21,0,37
2017,Marzo,3,3/1/2017,Sierra Leona,0,2,0,2
2017,Marzo,3,3/1/2017,Singapur,21,52,0,73
2017,Marzo,3,3/1/2017,República Árabe Siria,2,1,0,3
2017,Marzo,3,3/1/2017,Somalia,0,1,0,1
2017,Marzo,3,3/1/2017,Sri Lanka,3,8,0,11
2017,Marzo,3,3/1/2017,Sudáfrica,50,95,0,145
2017,Marzo,3,3/1/2017,Sudán,0,1,0,1
2017,Marzo,3,3/1/2017,Suecia,344,467,0,811
2017,Marzo,3,3/1/2017,Suiza,594,931,0,1525
2017,Marzo,3,3/1/2017,Surinam,17,30,0,47
2017,Marzo,3,3/1/2017,Taiwán,99,151,0,250
2017,Marzo,3,3/1/2017,República de Tayikistán,0,2,0,2
2017,Marzo,3,3/1/2017,Tailandia,16,12,0,28
2017,Marzo,3,3/1/2017,Tanzania,0,2,0,2
2017,Marzo,3,3/1/2017,República Democrática de Timor Oriental,0,2,0,2
2017,Marzo,3,3/1/2017,Togo,0,2,0,2
2017,Marzo,3,3/1/2017,Trinidad y Tobago,24,79,0,103
2017,Marzo,3,3/1/2017,Túnez,1,3,0,4
2017,Marzo,3,3/1/2017,Turquía,189,419,0,608
2017,Marzo,3,3/1/2017,Ucrania,34,44,0,78
2017,Marzo,3,3/1/2017,Uganda,3,5,0,8
2017,Marzo,3,3/1/2017,Uruguay,416,649,0,1065
2017,Marzo,3,3/1/2017,Venezuela,17325,22462,0,39787
2017,Marzo,3,3/1/2017,Vietnam,14,8,0,22
2017,Marzo,3,3/1/2017,República Árabe de Yemen,0,1,0,1
2017,Marzo,3,3/1/2017,Zambia,1,2,0,3
2017,Marzo,3,3/1/2017,Zimbabue,3,5,0,8
2017,Marzo,3,3/1/2017,Islas Turcas y Caicos/Territorio Británico de Ultramar,1,1,0,2
2017,Marzo,3,3/1/2017,Refugiado Otro,0,1,0,1
2017,Marzo,3,3/1/2017,Refugiado,1,1,0,2
2017,Marzo,3,3/1/2017,Desconocido,89,162,0,251
2017,Abril,4,4/1/2017,Afganistán,0,1,0,1
2017,Abril,4,4/1/2017,Albania,2,4,0,6
2017,Abril,4,4/1/2017,Alemania,2204,2946,0,5150
2017,Abril,4,4/1/2017,Andorra,2,8,0,10
2017,Abril,4,4/1/2017,Angola,0,1,0,1
2017,Abril,4,4/1/2017,Antigua y Barbuda,3,4,0,7
2017,Abril,4,4/1/2017,Países Bajos,2046,2702,0,4748
2017,Abril,4,4/1/2017,Arabia Saudita,1,5,0,6
2017,Abril,4,4/1/2017,Argelia,0,3,0,3
2017,Abril,4,4/1/2017,Argentina,7730,8221,0,15951
2017,Abril,4,4/1/2017,República de Armenia,1,3,0,4
2017,Abril,4,4/1/2017,Aruba,0,1,0,1
2017,Abril,4,4/1/2017,Australia,452,712,0,1164
2017,Abril,4,4/1/2017,Austria,156,284,0,440
2017,Abril,4,4/1/2017,Azerbaiyán,1,4,0,5
2017,Abril,4,4/1/2017,Bahamas,9,15,0,24
2017,Abril,4,4/1/2017,Bahréin,1,0,0,1
2017,Abril,4,4/1/2017,Bangladesh,1,5,0,6
2017,Abril,4,4/1/2017,Barbados,14,13,0,27
2017,Abril,4,4/1/2017,República de Belarús,8,5,0,13
2017,Abril,4,4/1/2017,Bélgica,252,515,0,767
2017,Abril,4,4/1/2017,Belice,2,6,0,8
2017,Abril,4,4/1/2017,Bermudas/Territorio Británico de Ultramar,1,1,0,2
2017,Abril,4,4/1/2017,Bolivia,666,801,0,1467
2017,Abril,4,4/1/2017,Bosnia y Herzegovina,1,5,0,6
2017,Abril,4,4/1/2017,Brasil,7554,8113,0,15667
2017,Abril,4,4/1/2017,Bulgaria,28,47,0,75
2017,Abril,4,4/1/2017,Burkina Faso,2,4,0,6
2017,Abril,4,4/1/2017,Burundi,0,1,0,1
2017,Abril,4,4/1/2017,Islas Caimán/Territorio Británico de Ultramar,4,11,0,15
2017,Abril,4,4/1/2017,Camerún,0,3,0,3
2017,Abril,4,4/1/2017,Canadá,1406,2362,0,3768
2017,Abril,4,4/1/2017,España,3603,6714,0,10317
2017,Abril,4,4/1/2017,República Democrática del Congo,2,1,0,3
2017,Abril,4,4/1/2017,República de Corea,229,513,0,742
2017,Abril,4,4/1/2017,Costa de Marfil,3,3,0,6
2017,Abril,4,4/1/2017,Costa Rica,2319,2450,0,4769
2017,Abril,4,4/1/2017,Croacia,18,74,0,92
2017,Abril,4,4/1/2017,Cuba,265,418,0,683
2017,Abril,4,4/1/2017,República Checa,74,93,0,167
2017,Abril,4,4/1/2017,Chile,4699,5682,0,10381
2017,Abril,4,4/1/2017,China,393,930,0,1323
2017,Abril,4,4/1/2017,Chipre,0,9,0,9
2017,Abril,4,4/1/2017,Dinamarca,174,298,0,472
2017,Abril,4,4/1/2017,Dominica,2,5,0,7
2017,Abril,4,4/1/2017,Ecuador,6451,7955,0,14406
2017,Abril,4,4/1/2017,Egipto,2,22,0,24
2017,Abril,4,4/1/2017,El Salvador,1315,1416,0,2731
2017,Abril,4,4/1/2017,Emiratos Árabes,2,12,0,14
2017,Abril,4,4/1/2017,Eritrea,0,1,0,1
2017,Abril,4,4/1/2017,Eslovaquia,37,32,0,69
2017,Abril,4,4/1/2017,Eslovenia,21,56,0,77
2017,Abril,4,4/1/2017,Estados Unidos de América,14715,25123,0,39838
2017,Abril,4,4/1/2017,Estonia,6,7,0,13
2017,Abril,4,4/1/2017,Etiopia,0,9,0,9
2017,Abril,4,4/1/2017,Filipinas,43,362,0,405
2017,Abril,4,4/1/2017,Finlandia,57,88,0,145
2017,Abril,4,4/1/2017,Francia,2311,3373,0,5684
2017,Abril,4,4/1/2017,Georgia,3,13,0,16
2017,Abril,4,4/1/2017,Ghana,3,11,0,14
2017,Abril,4,4/1/2017,Granada,1,4,0,5
2017,Abril,4,4/1/2017,Grecia,56,114,0,170
2017,Abril,4,4/1/2017,Guatemala,803,1273,0,2076
2017,Abril,4,4/1/2017,Guyana,5,12,0,17
2017,Abril,4,4/1/2017,Guinea Bissau,1,2,0,3
2017,Abril,4,4/1/2017,Haití,12,22,0,34
2017,Abril,4,4/1/2017,Honduras,481,560,0,1041
2017,Abril,4,4/1/2017,Hong Kong,5,5,0,10
2017,Abril,4,4/1/2017,Hungría,34,56,0,90
2017,Abril,4,4/1/2017,India,75,522,0,597
2017,Abril,4,4/1/2017,Indonesia,28,65,0,93
2017,Abril,4,4/1/2017,Iraq,0,4,0,4
2017,Abril,4,4/1/2017,Irán,4,5,0,9
2017,Abril,4,4/1/2017,República de Irlanda,158,255,0,413
2017,Abril,4,4/1/2017,Islandia,9,18,0,27
2017,Abril,4,4/1/2017,Israel,805,1536,0,2341
2017,Abril,4,4/1/2017,Italia,954,2193,0,3147
2017,Abril,4,4/1/2017,Jamaica,38,40,0,78
2017,Abril,4,4/1/2017,Japón,213,477,0,690
2017,Abril,4,4/1/2017,Jordania,0,11,0,11
2017,Abril,4,4/1/2017,Kazajistán,6,4,0,10
2017,Abril,4,4/1/2017,Kenia,7,19,0,26
2017,Abril,4,4/1/2017,Kiribati,0,1,0,1
2017,Abril,4,4/1/2017,Kuwait,1,6,0,7
2017,Abril,4,4/1/2017,República de Kosovo,1,1,0,2
2017,Abril,4,4/1/2017,Letonia,12,10,0,22
2017,Abril,4,4/1/2017,Lituania,30,42,0,72
2017,Abril,4,4/1/2017,Líbano,19,29,0,48
2017,Abril,4,4/1/2017,Liberia,1,0,0,1
2017,Abril,4,4/1/2017,Libia,0,2,0,2
2017,Abril,4,4/1/2017,Liechtenstein,5,2,0,7
2017,Abril,4,4/1/2017,Luxemburgo,4,9,0,13
2017,Abril,4,4/1/2017,Macedonia,2,6,0,8
2017,Abril,4,4/1/2017,Madagascar,1,0,0,1
2017,Abril,4,4/1/2017,Malasia,12,30,0,42
2017,Abril,4,4/1/2017,Malawi,0,1,0,1
2017,Abril,4,4/1/2017,Malí,0,1,0,1
2017,Abril,4,4/1/2017,Malta,4,21,0,25
2017,Abril,4,4/1/2017,Marruecos,14,20,0,34
2017,Abril,4,4/1/2017,Mauricio,5,10,0,15
2017,Abril,4,4/1/2017,México,6016,9165,0,15181
2017,Abril,4,4/1/2017,República de Moldavia,3,0,0,3
2017,Abril,4,4/1/2017,Mónaco,3,0,0,3
2017,Abril,4,4/1/2017,Montenegro,0,6,0,6
2017,Abril,4,4/1/2017,Mozambique,2,4,0,6
2017,Abril,4,4/1/2017,Myanmar,0,19,0,19
2017,Abril,4,4/1/2017,Nepal,2,2,0,4
2017,Abril,4,4/1/2017,Nicaragua,117,160,0,277
2017,Abril,4,4/1/2017,Nigeria,0,16,0,16
2017,Abril,4,4/1/2017,Noruega,171,202,0,373
2017,Abril,4,4/1/2017,Nueva Zelanda,72,134,0,206
2017,Abril,4,4/1/2017,Omán,0,2,0,2
2017,Abril,4,4/1/2017,Pakistán,3,18,0,21
2017,Abril,4,4/1/2017,Panamá,4147,3902,0,8049
2017,Abril,4,4/1/2017,Paraguay,318,302,0,620
2017,Abril,4,4/1/2017,Perú,4730,5656,0,10386
2017,Abril,4,4/1/2017,Palestina,1,1,0,2
2017,Abril,4,4/1/2017,Polonia,162,233,0,395
2017,Abril,4,4/1/2017,Portugal,315,587,0,902
2017,Abril,4,4/1/2017,Reino Unido de Gran Bretaña e Irlanda del Norte,1729,2847,0,4576
2017,Abril,4,4/1/2017,Federación de Rusia,236,366,0,602
2017,Abril,4,4/1/2017,República Dominicana,920,977,0,1897
2017,Abril,4,4/1/2017,Rumania,55,94,0,149
2017,Abril,4,4/1/2017,San Cristóbal y Nevis,1,2,0,3
2017,Abril,4,4/1/2017,San Marino,1,0,0,1
2017,Abril,4,4/1/2017,San  Vicente y las Granadinas,0,4,0,4
2017,Abril,4,4/1/2017,Santa Lucia,5,2,0,7
2017,Abril,4,4/1/2017,Senegal,0,3,0,3
2017,Abril,4,4/1/2017,Serbia,11,20,0,31
2017,Abril,4,4/1/2017,Sierra Leona,0,1,0,1
2017,Abril,4,4/1/2017,Singapur,18,29,0,47
2017,Abril,4,4/1/2017,República Árabe Siria,1,10,0,11
2017,Abril,4,4/1/2017,Sri Lanka,1,10,0,11
2017,Abril,4,4/1/2017,Sudáfrica,59,87,0,146
2017,Abril,4,4/1/2017,Sudán,0,2,0,2
2017,Abril,4,4/1/2017,Suecia,260,356,0,616
2017,Abril,4,4/1/2017,Suiza,624,901,0,1525
2017,Abril,4,4/1/2017,Surinam,37,33,0,70
2017,Abril,4,4/1/2017,Taiwán,82,102,0,184
2017,Abril,4,4/1/2017,Tailandia,20,9,0,29
2017,Abril,4,4/1/2017,Tanzania,0,1,0,1
2017,Abril,4,4/1/2017,Togo,0,1,0,1
2017,Abril,4,4/1/2017,Trinidad y Tobago,24,71,0,95
2017,Abril,4,4/1/2017,Túnez,7,6,0,13
2017,Abril,4,4/1/2017,Turquía,135,272,0,407
2017,Abril,4,4/1/2017,Ucrania,24,76,0,100
2017,Abril,4,4/1/2017,Uganda,3,2,0,5
2017,Abril,4,4/1/2017,Uruguay,563,709,0,1272
2017,Abril,4,4/1/2017,Venezuela,20246,23385,0,43631
2017,Abril,4,4/1/2017,Vietnam,4,5,0,9
2017,Abril,4,4/1/2017,República Árabe de Yemen,0,1,0,1
2017,Abril,4,4/1/2017,Zimbabue,1,2,0,3
2017,Abril,4,4/1/2017,Anguila/Territorio Británico de Ultramar,1,0,0,1
2017,Abril,4,4/1/2017,Refugiado,1,2,0,3
2017,Abril,4,4/1/2017,Desconocido,86,161,0,247
2017,Mayo,5,5/1/2017,Afganistán,0,2,0,2
2017,Mayo,5,5/1/2017,Albania,4,1,0,5
2017,Mayo,5,5/1/2017,Alemania,1624,2639,0,4263
2017,Mayo,5,5/1/2017,Andorra,0,10,0,10
2017,Mayo,5,5/1/2017,Angola,0,1,0,1
2017,Mayo,5,5/1/2017,Antigua y Barbuda,0,5,0,5
2017,Mayo,5,5/1/2017,Países Bajos,1505,2158,0,3663
2017,Mayo,5,5/1/2017,Arabia Saudita,0,9,0,9
2017,Mayo,5,5/1/2017,Argelia,3,12,0,15
2017,Mayo,5,5/1/2017,Argentina,7107,8072,0,15179
2017,Mayo,5,5/1/2017,República de Armenia,2,0,0,2
2017,Mayo,5,5/1/2017,Aruba,1,0,0,1
2017,Mayo,5,5/1/2017,Australia,445,773,0,1218
2017,Mayo,5,5/1/2017,Austria,138,232,0,370
2017,Mayo,5,5/1/2017,Azerbaiyán,7,11,0,18
2017,Mayo,5,5/1/2017,Bahamas,8,26,0,34
2017,Mayo,5,5/1/2017,Bahréin,0,1,0,1
2017,Mayo,5,5/1/2017,Bangladesh,4,16,0,20
2017,Mayo,5,5/1/2017,Barbados,19,25,0,44
2017,Mayo,5,5/1/2017,República de Belarús,4,6,0,10
2017,Mayo,5,5/1/2017,Bélgica,231,452,0,683
2017,Mayo,5,5/1/2017,Belice,8,18,0,26
2017,Mayo,5,5/1/2017,Bermudas/Territorio Británico de Ultramar,2,1,0,3
2017,Mayo,5,5/1/2017,Bolivia,1009,978,0,1987
2017,Mayo,5,5/1/2017,Bosnia y Herzegovina,3,4,0,7
2017,Mayo,5,5/1/2017,Brasil,7575,8649,0,16224
2017,Mayo,5,5/1/2017,Bulgaria,38,35,0,73
2017,Mayo,5,5/1/2017,Burkina Faso,0,2,0,2
2017,Mayo,5,5/1/2017,Islas Caimán/Territorio Británico de Ultramar,1,4,0,5
2017,Mayo,5,5/1/2017,Camerún,3,3,0,6
2017,Mayo,5,5/1/2017,Canadá,1310,2174,0,3484
2017,Mayo,5,5/1/2017,España,2745,6388,0,9133
2017,Mayo,5,5/1/2017,República Democrática del Congo,9,13,0,22
2017,Mayo,5,5/1/2017,República de Corea,225,491,0,716
2017,Mayo,5,5/1/2017,Costa de Marfil,0,10,0,10
2017,Mayo,5,5/1/2017,Costa Rica,1618,1959,0,3577
2017,Mayo,5,5/1/2017,Croacia,11,71,0,82
2017,Mayo,5,5/1/2017,Cuba,216,409,0,625
2017,Mayo,5,5/1/2017,República Checa,41,78,0,119
2017,Mayo,5,5/1/2017,Chile,4806,5924,0,10730
2017,Mayo,5,5/1/2017,China,518,1135,0,1653
2017,Mayo,5,5/1/2017,Chipre,3,4,0,7
2017,Mayo,5,5/1/2017,Dinamarca,103,190,0,293
2017,Mayo,5,5/1/2017,Dominica,5,3,0,8
2017,Mayo,5,5/1/2017,Ecuador,5843,8869,0,14712
2017,Mayo,5,5/1/2017,Egipto,2,23,0,25
2017,Mayo,5,5/1/2017,El Salvador,1061,1326,0,2387
2017,Mayo,5,5/1/2017,Emiratos Árabes,8,21,0,29
2017,Mayo,5,5/1/2017,Eslovaquia,23,29,0,52
2017,Mayo,5,5/1/2017,Eslovenia,14,34,0,48
2017,Mayo,5,5/1/2017,Estados Unidos de América,15267,26629,0,41896
2017,Mayo,5,5/1/2017,Estonia,12,22,0,34
2017,Mayo,5,5/1/2017,Etiopia,1,5,0,6
2017,Mayo,5,5/1/2017,Islas Fiji,1,0,0,1
2017,Mayo,5,5/1/2017,Filipinas,53,228,0,281
2017,Mayo,5,5/1/2017,Finlandia,59,80,0,139
2017,Mayo,5,5/1/2017,Francia,1740,2911,0,4651
2017,Mayo,5,5/1/2017,Georgia,7,11,0,18
2017,Mayo,5,5/1/2017,Ghana,8,6,0,14
2017,Mayo,5,5/1/2017,Granada,4,4,0,8
2017,Mayo,5,5/1/2017,Grecia,15,75,0,90
2017,Mayo,5,5/1/2017,Guatemala,762,1266,0,2028
2017,Mayo,5,5/1/2017,Guyana,10,18,0,28
2017,Mayo,5,5/1/2017,Guinea,0,1,0,1
2017,Mayo,5,5/1/2017,Haití,19,30,0,49
2017,Mayo,5,5/1/2017,Honduras,399,479,0,878
2017,Mayo,5,5/1/2017,Hong Kong,3,7,0,10
2017,Mayo,5,5/1/2017,Hungría,31,48,0,79
2017,Mayo,5,5/1/2017,India,122,618,0,740
2017,Mayo,5,5/1/2017,Indonesia,23,35,0,58
2017,Mayo,5,5/1/2017,Irán,7,21,0,28
2017,Mayo,5,5/1/2017,República de Irlanda,170,276,0,446
2017,Mayo,5,5/1/2017,Islandia,15,15,0,30
2017,Mayo,5,5/1/2017,Israel,585,1262,0,1847
2017,Mayo,5,5/1/2017,Italia,722,2033,0,2755
2017,Mayo,5,5/1/2017,Jamaica,26,40,0,66
2017,Mayo,5,5/1/2017,Japón,139,554,0,693
2017,Mayo,5,5/1/2017,Jordania,1,9,0,10
2017,Mayo,5,5/1/2017,Kazajistán,5,10,0,15
2017,Mayo,5,5/1/2017,Kenia,2,7,0,9
2017,Mayo,5,5/1/2017,Kiribati,0,1,0,1
2017,Mayo,5,5/1/2017,Kuwait,0,2,0,2
2017,Mayo,5,5/1/2017,República de Kosovo,1,2,0,3
2017,Mayo,5,5/1/2017,Letonia,7,12,0,19
2017,Mayo,5,5/1/2017,Lituania,23,17,0,40
2017,Mayo,5,5/1/2017,Líbano,16,37,0,53
2017,Mayo,5,5/1/2017,Liechtenstein,1,2,0,3
2017,Mayo,5,5/1/2017,Luxemburgo,9,14,0,23
2017,Mayo,5,5/1/2017,Macedonia,2,3,0,5
2017,Mayo,5,5/1/2017,Madagascar,1,0,0,1
2017,Mayo,5,5/1/2017,Malasia,9,30,0,39
2017,Mayo,5,5/1/2017,Malawi,0,1,0,1
2017,Mayo,5,5/1/2017,Malí,0,2,0,2
2017,Mayo,5,5/1/2017,Malta,6,8,0,14
2017,Mayo,5,5/1/2017,Marruecos,8,14,0,22
2017,Mayo,5,5/1/2017,Mauricio,1,6,0,7
2017,Mayo,5,5/1/2017,México,5093,8754,0,13847
2017,Mayo,5,5/1/2017,República de Moldavia,9,2,0,11
2017,Mayo,5,5/1/2017,Mónaco,1,0,0,1
2017,Mayo,5,5/1/2017,Mongolia,1,0,0,1
2017,Mayo,5,5/1/2017,Montenegro,0,4,0,4
2017,Mayo,5,5/1/2017,Mozambique,0,2,0,2
2017,Mayo,5,5/1/2017,Myanmar,1,2,0,3
2017,Mayo,5,5/1/2017,Namibia,1,0,0,1
2017,Mayo,5,5/1/2017,Nepal,0,2,0,2
2017,Mayo,5,5/1/2017,Nicaragua,122,163,0,285
2017,Mayo,5,5/1/2017,Nigeria,5,21,0,26
2017,Mayo,5,5/1/2017,Noruega,99,150,0,249
2017,Mayo,5,5/1/2017,Nueva Zelanda,116,172,0,288
2017,Mayo,5,5/1/2017,Pakistán,4,24,0,28
2017,Mayo,5,5/1/2017,Panamá,2800,3253,0,6053
2017,Mayo,5,5/1/2017,Paraguay,413,339,0,752
2017,Mayo,5,5/1/2017,Perú,5474,6479,0,11953
2017,Mayo,5,5/1/2017,Palestina,0,1,0,1
2017,Mayo,5,5/1/2017,Polonia,151,216,0,367
2017,Mayo,5,5/1/2017,Portugal,208,525,0,733
2017,Mayo,5,5/1/2017,Puerto Rico/Territorio de Estados Unidos,1,0,0,1
2017,Mayo,5,5/1/2017,Qatar,0,1,0,1
2017,Mayo,5,5/1/2017,Reino Unido de Gran Bretaña e Irlanda del Norte,1342,2410,0,3752
2017,Mayo,5,5/1/2017,República CentroÁfricana,1,0,0,1
2017,Mayo,5,5/1/2017,Federación de Rusia,176,226,0,402
2017,Mayo,5,5/1/2017,República Dominicana,579,835,0,1414
2017,Mayo,5,5/1/2017,Rumania,60,92,0,152
2017,Mayo,5,5/1/2017,Rwanda,3,10,0,13
2017,Mayo,5,5/1/2017,San Cristóbal y Nevis,0,6,0,6
2017,Mayo,5,5/1/2017,San Marino,1,1,0,2
2017,Mayo,5,5/1/2017,San  Vicente y las Granadinas,5,6,0,11
2017,Mayo,5,5/1/2017,Santa Lucia,3,2,0,5
2017,Mayo,5,5/1/2017,Santa Sede/Ciudad del Vaticano,0,5,0,5
2017,Mayo,5,5/1/2017,Senegal,1,3,0,4
2017,Mayo,5,5/1/2017,Serbia,10,14,0,24
2017,Mayo,5,5/1/2017,Sierra Leona,0,1,0,1
2017,Mayo,5,5/1/2017,Singapur,18,36,0,54
2017,Mayo,5,5/1/2017,República Árabe Siria,0,2,0,2
2017,Mayo,5,5/1/2017,Sri Lanka,0,4,0,4
2017,Mayo,5,5/1/2017,Sudáfrica,38,63,0,101
2017,Mayo,5,5/1/2017,Sudán,0,2,0,2
2017,Mayo,5,5/1/2017,Suecia,176,292,0,468
2017,Mayo,5,5/1/2017,Suiza,435,725,0,1160
2017,Mayo,5,5/1/2017,Surinam,10,44,0,54
2017,Mayo,5,5/1/2017,Taiwán,65,92,0,157
2017,Mayo,5,5/1/2017,Tailandia,16,14,0,30
2017,Mayo,5,5/1/2017,Tanzania,1,1,0,2
2017,Mayo,5,5/1/2017,Trinidad y Tobago,27,68,0,95
2017,Mayo,5,5/1/2017,Túnez,5,9,0,14
2017,Mayo,5,5/1/2017,Turquía,150,301,0,451
2017,Mayo,5,5/1/2017,Ucrania,27,48,0,75
2017,Mayo,5,5/1/2017,Uganda,7,11,0,18
2017,Mayo,5,5/1/2017,Uruguay,536,744,0,1280
2017,Mayo,5,5/1/2017,Venezuela,20382,25463,0,45845
2017,Mayo,5,5/1/2017,Vietnam,7,23,0,30
2017,Mayo,5,5/1/2017,Zambia,5,5,0,10
2017,Mayo,5,5/1/2017,Zimbabue,1,10,0,11
2017,Mayo,5,5/1/2017,Anguila/Territorio Británico de Ultramar,0,1,0,1
2017,Mayo,5,5/1/2017,Refugiado,2,3,0,5
2017,Mayo,5,5/1/2017,Desconocido,82,147,0,229
2017,Junio,6,6/1/2017,Albania,2,3,0,5
2017,Junio,6,6/1/2017,Alemania,1726,2439,0,4165
2017,Junio,6,6/1/2017,Andorra,3,9,0,12
2017,Junio,6,6/1/2017,Antigua y Barbuda,0,3,0,3
2017,Junio,6,6/1/2017,Países Bajos,1504,2011,0,3515
2017,Junio,6,6/1/2017,Arabia Saudita,1,12,0,13
2017,Junio,6,6/1/2017,Argelia,1,8,0,9
2017,Junio,6,6/1/2017,Argentina,6021,7236,0,13257
2017,Junio,6,6/1/2017,República de Armenia,3,3,0,6
2017,Junio,6,6/1/2017,Australia,529,828,0,1357
2017,Junio,6,6/1/2017,Austria,156,248,0,404
2017,Junio,6,6/1/2017,Azerbaiyán,3,2,0,5
2017,Junio,6,6/1/2017,Bahamas,5,21,0,26
2017,Junio,6,6/1/2017,Bangladesh,0,2,0,2
2017,Junio,6,6/1/2017,Barbados,4,12,0,16
2017,Junio,6,6/1/2017,República de Belarús,6,8,0,14
2017,Junio,6,6/1/2017,Bélgica,327,534,0,861
2017,Junio,6,6/1/2017,Belice,10,18,0,28
2017,Junio,6,6/1/2017,Bermudas/Territorio Británico de Ultramar,0,5,0,5
2017,Junio,6,6/1/2017,Bolivia,872,824,0,1696
2017,Junio,6,6/1/2017,Bosnia y Herzegovina,1,1,0,2
2017,Junio,6,6/1/2017,Brasil,6871,7640,0,14511
2017,Junio,6,6/1/2017,Bulgaria,20,37,0,57
2017,Junio,6,6/1/2017,Burkina Faso,0,3,0,3
2017,Junio,6,6/1/2017,Cabo Verde,1,0,0,1
2017,Junio,6,6/1/2017,Islas Caimán/Territorio Británico de Ultramar,1,4,0,5
2017,Junio,6,6/1/2017,Camboya,0,1,0,1
2017,Junio,6,6/1/2017,Camerún,2,4,0,6
2017,Junio,6,6/1/2017,Canadá,1379,2170,0,3549
2017,Junio,6,6/1/2017,Chad,0,1,0,1
2017,Junio,6,6/1/2017,España,3311,6611,0,9922
2017,Junio,6,6/1/2017,República Democrática del Congo,1,6,0,7
2017,Junio,6,6/1/2017,República de Corea,345,542,0,887
2017,Junio,6,6/1/2017,Costa de Marfil,1,7,0,8
2017,Junio,6,6/1/2017,Costa Rica,1473,1744,0,3217
2017,Junio,6,6/1/2017,Croacia,10,49,0,59
2017,Junio,6,6/1/2017,Cuba,264,489,0,753
2017,Junio,6,6/1/2017,República Checa,43,59,0,102
2017,Junio,6,6/1/2017,Chile,4723,5720,0,10443
2017,Junio,6,6/1/2017,China,484,969,0,1453
2017,Junio,6,6/1/2017,Chipre,2,5,0,7
2017,Junio,6,6/1/2017,Dinamarca,134,227,0,361
2017,Junio,6,6/1/2017,Dominica,1,5,0,6
2017,Junio,6,6/1/2017,Ecuador,4563,6920,0,11483
2017,Junio,6,6/1/2017,Egipto,2,25,0,27
2017,Junio,6,6/1/2017,El Salvador,820,1059,0,1879
2017,Junio,6,6/1/2017,Emiratos Árabes,3,7,0,10
2017,Junio,6,6/1/2017,Eritrea,0,1,0,1
2017,Junio,6,6/1/2017,Eslovaquia,26,30,0,56
2017,Junio,6,6/1/2017,Eslovenia,15,34,0,49
2017,Junio,6,6/1/2017,Estados Unidos de América,23200,33250,0,56450
2017,Junio,6,6/1/2017,Estonia,14,12,0,26
2017,Junio,6,6/1/2017,Etiopia,3,7,0,10
2017,Junio,6,6/1/2017,Islas Fiji,1,1,0,2
2017,Junio,6,6/1/2017,Filipinas,69,287,0,356
2017,Junio,6,6/1/2017,Finlandia,69,77,0,146
2017,Junio,6,6/1/2017,Francia,1790,2943,0,4733
2017,Junio,6,6/1/2017,Georgia,5,11,0,16
2017,Junio,6,6/1/2017,Ghana,8,9,0,17
2017,Junio,6,6/1/2017,Granada,2,2,0,4
2017,Junio,6,6/1/2017,Grecia,31,76,0,107
2017,Junio,6,6/1/2017,Guatemala,673,1035,0,1708
2017,Junio,6,6/1/2017,Guyana,8,15,0,23
2017,Junio,6,6/1/2017,Guinea,1,7,0,8
2017,Junio,6,6/1/2017,Haití,14,31,0,45
2017,Junio,6,6/1/2017,Honduras,254,377,0,631
2017,Junio,6,6/1/2017,Hong Kong,3,5,0,8
2017,Junio,6,6/1/2017,Hungría,41,49,0,90
2017,Junio,6,6/1/2017,India,97,492,0,589
2017,Junio,6,6/1/2017,Indonesia,28,37,0,65
2017,Junio,6,6/1/2017,Iraq,1,0,0,1
2017,Junio,6,6/1/2017,Irán,5,10,0,15
2017,Junio,6,6/1/2017,República de Irlanda,184,321,0,505
2017,Junio,6,6/1/2017,Islandia,17,9,0,26
2017,Junio,6,6/1/2017,Israel,359,861,0,1220
2017,Junio,6,6/1/2017,Italia,791,2004,0,2795
2017,Junio,6,6/1/2017,Jamaica,37,46,0,83
2017,Junio,6,6/1/2017,Japón,189,528,0,717
2017,Junio,6,6/1/2017,Jordania,5,9,0,14
2017,Junio,6,6/1/2017,Kazajistán,4,2,0,6
2017,Junio,6,6/1/2017,Kenia,8,9,0,17
2017,Junio,6,6/1/2017,Kirguistán,0,2,0,2
2017,Junio,6,6/1/2017,Kuwait,1,1,0,2
2017,Junio,6,6/1/2017,República de Kosovo,0,1,0,1
2017,Junio,6,6/1/2017,República Democrática Popular  Lao,1,1,0,2
2017,Junio,6,6/1/2017,Letonia,10,10,0,20
2017,Junio,6,6/1/2017,Lituania,40,25,0,65
2017,Junio,6,6/1/2017,Líbano,22,25,0,47
2017,Junio,6,6/1/2017,Liechtenstein,3,4,0,7
2017,Junio,6,6/1/2017,Luxemburgo,2,12,0,14
2017,Junio,6,6/1/2017,Macedonia,0,4,0,4
2017,Junio,6,6/1/2017,Madagascar,4,0,0,4
2017,Junio,6,6/1/2017,Malasia,12,33,0,45
2017,Junio,6,6/1/2017,Malí,0,2,0,2
2017,Junio,6,6/1/2017,Malta,6,10,0,16
2017,Junio,6,6/1/2017,Marruecos,2,14,0,16
2017,Junio,6,6/1/2017,Mauricio,0,4,0,4
2017,Junio,6,6/1/2017,Mauritania,0,1,0,1
2017,Junio,6,6/1/2017,México,5254,8750,0,14004
2017,Junio,6,6/1/2017,República de Moldavia,7,2,0,9
2017,Junio,6,6/1/2017,Mónaco,1,0,0,1
2017,Junio,6,6/1/2017,Mongolia,5,5,0,10
2017,Junio,6,6/1/2017,Montenegro,0,4,0,4
2017,Junio,6,6/1/2017,Mozambique,0,1,0,1
2017,Junio,6,6/1/2017,Myanmar,1,1,0,2
2017,Junio,6,6/1/2017,Namibia,2,0,0,2
2017,Junio,6,6/1/2017,Nepal,3,3,0,6
2017,Junio,6,6/1/2017,Nicaragua,114,115,0,229
2017,Junio,6,6/1/2017,Nigeria,3,12,0,15
2017,Junio,6,6/1/2017,Noruega,225,317,0,542
2017,Junio,6,6/1/2017,Nueva Zelanda,101,152,0,253
2017,Junio,6,6/1/2017,Omán,1,2,0,3
2017,Junio,6,6/1/2017,Papúa Nueva Guinea,0,1,0,1
2017,Junio,6,6/1/2017,Pakistán,3,13,0,16
2017,Junio,6,6/1/2017,Panamá,3535,3630,0,7165
2017,Junio,6,6/1/2017,Paraguay,366,339,0,705
2017,Junio,6,6/1/2017,Perú,4887,5922,0,10809
2017,Junio,6,6/1/2017,Palestina,2,4,0,6
2017,Junio,6,6/1/2017,Polonia,135,178,0,313
2017,Junio,6,6/1/2017,Portugal,233,461,0,694
2017,Junio,6,6/1/2017,Puerto Rico/Territorio de Estados Unidos,1,0,0,1
2017,Junio,6,6/1/2017,Qatar,0,1,0,1
2017,Junio,6,6/1/2017,Reino Unido de Gran Bretaña e Irlanda del Norte,1525,2564,0,4089
2017,Junio,6,6/1/2017,República CentroÁfricana,1,0,0,1
2017,Junio,6,6/1/2017,Federación de Rusia,178,219,0,397
2017,Junio,6,6/1/2017,República Dominicana,611,848,0,1459
2017,Junio,6,6/1/2017,Rumania,60,95,0,155
2017,Junio,6,6/1/2017,San Cristóbal y Nevis,0,3,0,3
2017,Junio,6,6/1/2017,San Marino,0,2,0,2
2017,Junio,6,6/1/2017,San  Vicente y las Granadinas,0,1,0,1
2017,Junio,6,6/1/2017,Santa Lucia,2,2,0,4
2017,Junio,6,6/1/2017,Santa Sede/Ciudad del Vaticano,0,2,0,2
2017,Junio,6,6/1/2017,Senegal,1,0,0,1
2017,Junio,6,6/1/2017,Serbia,4,19,0,23
2017,Junio,6,6/1/2017,Sierra Leona,0,2,0,2
2017,Junio,6,6/1/2017,Singapur,24,34,0,58
2017,Junio,6,6/1/2017,República Árabe Siria,1,2,0,3
2017,Junio,6,6/1/2017,Sri Lanka,1,2,0,3
2017,Junio,6,6/1/2017,Sudáfrica,43,103,0,146
2017,Junio,6,6/1/2017,Sudán,0,1,0,1
2017,Junio,6,6/1/2017,Suecia,300,453,0,753
2017,Junio,6,6/1/2017,Suiza,522,794,0,1316
2017,Junio,6,6/1/2017,Surinam,7,21,0,28
2017,Junio,6,6/1/2017,Taiwán,64,98,0,162
2017,Junio,6,6/1/2017,Tailandia,44,30,0,74
2017,Junio,6,6/1/2017,Tanzania,2,2,0,4
2017,Junio,6,6/1/2017,Togo,0,1,0,1
2017,Junio,6,6/1/2017,Trinidad y Tobago,38,65,0,103
2017,Junio,6,6/1/2017,Túnez,3,10,0,13
2017,Junio,6,6/1/2017,Turquía,165,332,0,497
2017,Junio,6,6/1/2017,Ucrania,22,42,0,64
2017,Junio,6,6/1/2017,Uganda,2,0,0,2
2017,Junio,6,6/1/2017,Uruguay,673,883,0,1556
2017,Junio,6,6/1/2017,Uzbekistán,2,0,0,2
2017,Junio,6,6/1/2017,Venezuela,20964,26124,0,47088
2017,Junio,6,6/1/2017,Vietnam,11,4,0,15
2017,Junio,6,6/1/2017,República Árabe de Yemen,0,1,0,1
2017,Junio,6,6/1/2017,Zambia,1,4,0,5
2017,Junio,6,6/1/2017,Zimbabue,1,9,0,10
2017,Junio,6,6/1/2017,Anguila/Territorio Británico de Ultramar,1,0,0,1
2017,Junio,6,6/1/2017,Refugiado,1,3,0,4
2017,Junio,6,6/1/2017,Desconocido,100,203,0,303
2017,Julio,7,7/1/2017,Afganistán,0,2,0,2
2017,Julio,7,7/1/2017,Albania,1,3,0,4
2017,Julio,7,7/1/2017,Alemania,2842,3426,0,6268
2017,Julio,7,7/1/2017,Andorra,1,11,0,12
2017,Julio,7,7/1/2017,Angola,2,8,0,10
2017,Julio,7,7/1/2017,Antigua y Barbuda,1,6,0,7
2017,Julio,7,7/1/2017,Países Bajos,3359,3924,0,7283
2017,Julio,7,7/1/2017,Arabia Saudita,0,9,0,9
2017,Julio,7,7/1/2017,Argelia,4,9,0,13
2017,Julio,7,7/1/2017,Argentina,8662,8946,0,17608
2017,Julio,7,7/1/2017,República de Armenia,1,4,0,5
2017,Julio,7,7/1/2017,Australia,613,923,0,1536
2017,Julio,7,7/1/2017,Austria,371,435,0,806
2017,Julio,7,7/1/2017,Azerbaiyán,4,9,0,13
2017,Julio,7,7/1/2017,Bahamas,21,15,0,36
2017,Julio,7,7/1/2017,Bahréin,1,4,0,5
2017,Julio,7,7/1/2017,Bangladesh,3,6,0,9
2017,Julio,7,7/1/2017,Barbados,46,60,0,106
2017,Julio,7,7/1/2017,República de Belarús,2,5,0,7
2017,Julio,7,7/1/2017,Bélgica,754,928,0,1682
2017,Julio,7,7/1/2017,Belice,16,25,0,41
2017,Julio,7,7/1/2017,Benín,1,1,0,2
2017,Julio,7,7/1/2017,Bermudas/Territorio Británico de Ultramar,0,9,0,9
2017,Julio,7,7/1/2017,Bolivia,990,986,0,1976
2017,Julio,7,7/1/2017,Bosnia y Herzegovina,1,2,0,3
2017,Julio,7,7/1/2017,Brasil,8719,9371,0,18090
2017,Julio,7,7/1/2017,Brunei Darussalam,2,0,0,2
2017,Julio,7,7/1/2017,Bulgaria,27,31,0,58
2017,Julio,7,7/1/2017,Burundi,0,1,0,1
2017,Julio,7,7/1/2017,Bután,0,3,0,3
2017,Julio,7,7/1/2017,Islas Caimán/Territorio Británico de Ultramar,5,2,0,7
2017,Julio,7,7/1/2017,Camboya,0,4,0,4
2017,Julio,7,7/1/2017,Camerún,7,19,0,26
2017,Julio,7,7/1/2017,Canadá,1743,2495,0,4238
2017,Julio,7,7/1/2017,España,4197,7268,0,11465
2017,Julio,7,7/1/2017,República Del Congo,0,1,0,1
2017,Julio,7,7/1/2017,República Democrática del Congo,3,4,0,7
2017,Julio,7,7/1/2017,República de Corea,278,510,0,788
2017,Julio,7,7/1/2017,Costa de Marfil,1,6,0,7
2017,Julio,7,7/1/2017,Costa Rica,1902,2025,0,3927
2017,Julio,7,7/1/2017,Croacia,17,38,0,55
2017,Julio,7,7/1/2017,Cuba,347,539,0,886
2017,Julio,7,7/1/2017,República Checa,91,105,0,196
2017,Julio,7,7/1/2017,Chile,6247,6622,0,12869
2017,Julio,7,7/1/2017,China,551,945,0,1496
2017,Julio,7,7/1/2017,Chipre,6,12,0,18
2017,Julio,7,7/1/2017,Dinamarca,252,350,0,602
2017,Julio,7,7/1/2017,Dominica,3,7,0,10
2017,Julio,7,7/1/2017,Ecuador,6578,8564,0,15142
2017,Julio,7,7/1/2017,Egipto,10,49,0,59
2017,Julio,7,7/1/2017,El Salvador,994,1190,0,2184
2017,Julio,7,7/1/2017,Emiratos Árabes,9,17,0,26
2017,Julio,7,7/1/2017,Eritrea,0,1,0,1
2017,Julio,7,7/1/2017,Eslovaquia,36,39,0,75
2017,Julio,7,7/1/2017,Eslovenia,39,46,0,85
2017,Julio,7,7/1/2017,Estados Unidos de América,22627,31883,0,54510
2017,Julio,7,7/1/2017,Estonia,17,19,0,36
2017,Julio,7,7/1/2017,Etiopia,2,4,0,6
2017,Julio,7,7/1/2017,Islas Fiji,1,2,0,3
2017,Julio,7,7/1/2017,Filipinas,76,195,0,271
2017,Julio,7,7/1/2017,Finlandia,66,88,0,154
2017,Julio,7,7/1/2017,Francia,3759,4905,0,8664
2017,Julio,7,7/1/2017,Gabón,2,1,0,3
2017,Julio,7,7/1/2017,Georgia,5,4,0,9
2017,Julio,7,7/1/2017,Ghana,8,11,0,19
2017,Julio,7,7/1/2017,Granada,2,6,0,8
2017,Julio,7,7/1/2017,Grecia,51,83,0,134
2017,Julio,7,7/1/2017,Guatemala,569,1079,0,1648
2017,Julio,7,7/1/2017,Guyana,23,20,0,43
2017,Julio,7,7/1/2017,Guinea,1,0,0,1
2017,Julio,7,7/1/2017,Guinea Ecuatorial,0,2,0,2
2017,Julio,7,7/1/2017,Haití,8,21,0,29
2017,Julio,7,7/1/2017,Honduras,356,534,0,890
2017,Julio,7,7/1/2017,Hong Kong,9,4,0,13
2017,Julio,7,7/1/2017,Hungría,53,64,0,117
2017,Julio,7,7/1/2017,India,146,569,0,715
2017,Julio,7,7/1/2017,Indonesia,29,47,0,76
2017,Julio,7,7/1/2017,Iraq,1,3,0,4
2017,Julio,7,7/1/2017,Irán,8,16,0,24
2017,Julio,7,7/1/2017,República de Irlanda,308,397,0,705
2017,Julio,7,7/1/2017,Islandia,14,22,0,36
2017,Julio,7,7/1/2017,Israel,340,732,0,1072
2017,Julio,7,7/1/2017,Italia,1231,2304,0,3535
2017,Julio,7,7/1/2017,Jamaica,42,54,0,96
2017,Julio,7,7/1/2017,Japón,161,496,0,657
2017,Julio,7,7/1/2017,Jordania,4,10,0,14
2017,Julio,7,7/1/2017,Kazajistán,1,5,0,6
2017,Julio,7,7/1/2017,Kenia,14,16,0,30
2017,Julio,7,7/1/2017,Kiribati,0,6,0,6
2017,Julio,7,7/1/2017,Kuwait,6,3,0,9
2017,Julio,7,7/1/2017,República de Kosovo,0,2,0,2
2017,Julio,7,7/1/2017,República Democrática Popular  Lao,2,2,0,4
2017,Julio,7,7/1/2017,Lesoto,0,1,0,1
2017,Julio,7,7/1/2017,Letonia,10,12,0,22
2017,Julio,7,7/1/2017,Lituania,25,24,0,49
2017,Julio,7,7/1/2017,Líbano,31,31,0,62
2017,Julio,7,7/1/2017,Liberia,0,1,0,1
2017,Julio,7,7/1/2017,Liechtenstein,9,6,0,15
2017,Julio,7,7/1/2017,Luxemburgo,19,17,0,36
2017,Julio,7,7/1/2017,Macedonia,2,3,0,5
2017,Julio,7,7/1/2017,Madagascar,3,2,0,5
2017,Julio,7,7/1/2017,Malasia,16,34,0,50
2017,Julio,7,7/1/2017,Malawi,2,0,0,2
2017,Julio,7,7/1/2017,Maldivas,0,1,0,1
2017,Julio,7,7/1/2017,Malta,8,10,0,18
2017,Julio,7,7/1/2017,Marruecos,20,15,0,35
2017,Julio,7,7/1/2017,Mauricio,1,6,0,7
2017,Julio,7,7/1/2017,México,7253,10597,0,17850
2017,Julio,7,7/1/2017,República de Moldavia,2,0,0,2
2017,Julio,7,7/1/2017,Mónaco,1,0,0,1
2017,Julio,7,7/1/2017,Mongolia,3,2,0,5
2017,Julio,7,7/1/2017,Montenegro,1,3,0,4
2017,Julio,7,7/1/2017,Mozambique,1,3,0,4
2017,Julio,7,7/1/2017,Myanmar,4,10,0,14
2017,Julio,7,7/1/2017,Namibia,1,0,0,1
2017,Julio,7,7/1/2017,Nepal,3,11,0,14
2017,Julio,7,7/1/2017,Nicaragua,124,231,0,355
2017,Julio,7,7/1/2017,Nigeria,11,16,0,27
2017,Julio,7,7/1/2017,Noruega,275,325,0,600
2017,Julio,7,7/1/2017,Nueva Zelanda,173,209,0,382
2017,Julio,7,7/1/2017,Omán,0,2,0,2
2017,Julio,7,7/1/2017,Papúa Nueva Guinea,0,2,0,2
2017,Julio,7,7/1/2017,Pakistán,14,23,0,37
2017,Julio,7,7/1/2017,Panamá,3256,3505,0,6761
2017,Julio,7,7/1/2017,Paraguay,255,227,0,482
2017,Julio,7,7/1/2017,Perú,6367,6904,0,13271
2017,Julio,7,7/1/2017,Palestina,0,2,0,2
2017,Julio,7,7/1/2017,Polonia,210,205,0,415
2017,Julio,7,7/1/2017,Portugal,312,550,0,862
2017,Julio,7,7/1/2017,Qatar,0,2,0,2
2017,Julio,7,7/1/2017,Reino Unido de Gran Bretaña e Irlanda del Norte,1943,3002,0,4945
2017,Julio,7,7/1/2017,República CentroÁfricana,0,1,0,1
2017,Julio,7,7/1/2017,Federación de Rusia,182,194,0,376
2017,Julio,7,7/1/2017,República Dominicana,694,926,0,1620
2017,Julio,7,7/1/2017,Rumania,91,86,0,177
2017,Julio,7,7/1/2017,Rwanda,0,2,0,2
2017,Julio,7,7/1/2017,San Cristóbal y Nevis,1,6,0,7
2017,Julio,7,7/1/2017,San Marino,1,1,0,2
2017,Julio,7,7/1/2017,San  Vicente y las Granadinas,6,5,0,11
2017,Julio,7,7/1/2017,Santa Lucia,7,5,0,12
2017,Julio,7,7/1/2017,Senegal,0,1,0,1
2017,Julio,7,7/1/2017,Serbia,14,14,0,28
2017,Julio,7,7/1/2017,Sierra Leona,1,0,0,1
2017,Julio,7,7/1/2017,Singapur,25,29,0,54
2017,Julio,7,7/1/2017,República Árabe Siria,1,1,0,2
2017,Julio,7,7/1/2017,Sri Lanka,0,9,0,9
2017,Julio,7,7/1/2017,Sudáfrica,80,131,0,211
2017,Julio,7,7/1/2017,Sudán,1,1,0,2
2017,Julio,7,7/1/2017,Suecia,224,380,0,604
2017,Julio,7,7/1/2017,Suiza,1105,1376,0,2481
2017,Julio,7,7/1/2017,Surinam,23,29,0,52
2017,Julio,7,7/1/2017,Taiwán,90,116,0,206
2017,Julio,7,7/1/2017,Tailandia,33,8,0,41
2017,Julio,7,7/1/2017,Tanzania,2,5,0,7
2017,Julio,7,7/1/2017,Togo,1,4,0,5
2017,Julio,7,7/1/2017,Trinidad y Tobago,61,88,0,149
2017,Julio,7,7/1/2017,Túnez,4,10,0,14
2017,Julio,7,7/1/2017,Turquía,168,287,0,455
2017,Julio,7,7/1/2017,Ucrania,34,39,0,73
2017,Julio,7,7/1/2017,Uganda,1,5,0,6
2017,Julio,7,7/1/2017,Uruguay,654,753,0,1407
2017,Julio,7,7/1/2017,Uzbekistán,0,1,0,1
2017,Julio,7,7/1/2017,Venezuela,35498,38805,0,74303
2017,Julio,7,7/1/2017,Vietnam,14,18,0,32
2017,Julio,7,7/1/2017,Islas Vírgenes Británicas/Territorio Británico de Ultramar,0,1,0,1
2017,Julio,7,7/1/2017,Zimbabue,1,9,0,10
2017,Julio,7,7/1/2017,Anguila/Territorio Británico de Ultramar,0,1,0,1
2017,Julio,7,7/1/2017,Islas Turcas y Caicos/Territorio Británico de Ultramar,1,0,0,1
2017,Julio,7,7/1/2017,Refugiado,2,1,0,3
2017,Julio,7,7/1/2017,Desconocido,85,169,0,254
2017,Agosto,8,8/1/2017,Afganistán,0,1,0,1
2017,Agosto,8,8/1/2017,Albania,5,2,0,7
2017,Agosto,8,8/1/2017,Alemania,2924,3632,0,6556
2017,Agosto,8,8/1/2017,Andorra,6,18,0,24
2017,Agosto,8,8/1/2017,Angola,4,1,0,5
2017,Agosto,8,8/1/2017,Antigua y Barbuda,0,4,0,4
2017,Agosto,8,8/1/2017,Países Bajos,1990,2556,0,4546
2017,Agosto,8,8/1/2017,Arabia Saudita,0,16,0,16
2017,Agosto,8,8/1/2017,Argelia,8,13,0,21
2017,Agosto,8,8/1/2017,Argentina,6799,7881,0,14680
2017,Agosto,8,8/1/2017,República de Armenia,2,1,0,3
2017,Agosto,8,8/1/2017,Australia,496,815,0,1311
2017,Agosto,8,8/1/2017,Austria,286,363,0,649
2017,Agosto,8,8/1/2017,Azerbaiyán,2,8,0,10
2017,Agosto,8,8/1/2017,Bahamas,15,27,0,42
2017,Agosto,8,8/1/2017,Bahréin,0,2,0,2
2017,Agosto,8,8/1/2017,Bangladesh,1,2,0,3
2017,Agosto,8,8/1/2017,Barbados,12,14,0,26
2017,Agosto,8,8/1/2017,República de Belarús,3,7,0,10
2017,Agosto,8,8/1/2017,Bélgica,428,617,0,1045
2017,Agosto,8,8/1/2017,Belice,14,23,0,37
2017,Agosto,8,8/1/2017,Bermudas/Territorio Británico de Ultramar,5,7,0,12
2017,Agosto,8,8/1/2017,Bolivia,870,917,0,1787
2017,Agosto,8,8/1/2017,Bosnia y Herzegovina,2,3,0,5
2017,Agosto,8,8/1/2017,Brasil,8387,9343,0,17730
2017,Agosto,8,8/1/2017,Brunei Darussalam,0,1,0,1
2017,Agosto,8,8/1/2017,Bulgaria,19,30,0,49
2017,Agosto,8,8/1/2017,Burkina Faso,2,0,0,2
2017,Agosto,8,8/1/2017,Burundi,0,1,0,1
2017,Agosto,8,8/1/2017,Bután,0,1,0,1
2017,Agosto,8,8/1/2017,Cabo Verde,1,2,0,3
2017,Agosto,8,8/1/2017,Islas Caimán/Territorio Británico de Ultramar,3,3,0,6
2017,Agosto,8,8/1/2017,Camboya,0,1,0,1
2017,Agosto,8,8/1/2017,Camerún,1,4,0,5
2017,Agosto,8,8/1/2017,Canadá,1531,2368,0,3899
2017,Agosto,8,8/1/2017,Chad,0,1,0,1
2017,Agosto,8,8/1/2017,España,5472,8222,0,13694
2017,Agosto,8,8/1/2017,República Democrática del Congo,0,2,0,2
2017,Agosto,8,8/1/2017,República de Corea,254,486,0,740
2017,Agosto,8,8/1/2017,Costa de Marfil,0,1,0,1
2017,Agosto,8,8/1/2017,Costa Rica,1340,1833,0,3173
2017,Agosto,8,8/1/2017,Croacia,19,40,0,59
2017,Agosto,8,8/1/2017,Cuba,285,635,0,920
2017,Agosto,8,8/1/2017,República Checa,67,72,0,139
2017,Agosto,8,8/1/2017,Chile,5873,6696,0,12569
2017,Agosto,8,8/1/2017,China,442,931,0,1373
2017,Agosto,8,8/1/2017,Chipre,5,12,0,17
2017,Agosto,8,8/1/2017,Dinamarca,110,184,0,294
2017,Agosto,8,8/1/2017,Dominica,1,7,0,8
2017,Agosto,8,8/1/2017,Ecuador,9503,10764,0,20267
2017,Agosto,8,8/1/2017,Egipto,6,23,0,29
2017,Agosto,8,8/1/2017,El Salvador,1188,1372,0,2560
2017,Agosto,8,8/1/2017,Emiratos Árabes,8,20,0,28
2017,Agosto,8,8/1/2017,Eritrea,0,2,0,2
2017,Agosto,8,8/1/2017,Eslovaquia,26,38,0,64
2017,Agosto,8,8/1/2017,Eslovenia,12,32,0,44
2017,Agosto,8,8/1/2017,Estados Unidos de América,18199,30919,0,49118
2017,Agosto,8,8/1/2017,Estonia,9,9,0,18
2017,Agosto,8,8/1/2017,Etiopia,2,3,0,5
2017,Agosto,8,8/1/2017,Filipinas,59,315,0,374
2017,Agosto,8,8/1/2017,Finlandia,66,79,0,145
2017,Agosto,8,8/1/2017,Francia,3267,4531,0,7798
2017,Agosto,8,8/1/2017,Gabón,1,0,0,1
2017,Agosto,8,8/1/2017,Georgia,5,7,0,12
2017,Agosto,8,8/1/2017,Ghana,0,9,0,9
2017,Agosto,8,8/1/2017,Granada,3,5,0,8
2017,Agosto,8,8/1/2017,Grecia,31,87,0,118
2017,Agosto,8,8/1/2017,Guatemala,594,1156,0,1750
2017,Agosto,8,8/1/2017,Guyana,7,18,0,25
2017,Agosto,8,8/1/2017,Guinea Ecuatorial,0,3,0,3
2017,Agosto,8,8/1/2017,Guinea Bissau,0,2,0,2
2017,Agosto,8,8/1/2017,Haití,9,30,0,39
2017,Agosto,8,8/1/2017,Honduras,381,544,0,925
2017,Agosto,8,8/1/2017,Hong Kong,3,3,0,6
2017,Agosto,8,8/1/2017,Hungría,28,61,0,89
2017,Agosto,8,8/1/2017,India,108,533,0,641
2017,Agosto,8,8/1/2017,Indonesia,13,28,0,41
2017,Agosto,8,8/1/2017,Iraq,0,1,0,1
2017,Agosto,8,8/1/2017,Irán,13,27,0,40
2017,Agosto,8,8/1/2017,República de Irlanda,217,330,0,547
2017,Agosto,8,8/1/2017,Islandia,7,12,0,19
2017,Agosto,8,8/1/2017,Israel,304,714,0,1018
2017,Agosto,8,8/1/2017,Italia,1881,3486,0,5367
2017,Agosto,8,8/1/2017,Jamaica,26,50,0,76
2017,Agosto,8,8/1/2017,Japón,252,571,0,823
2017,Agosto,8,8/1/2017,Jordania,4,7,0,11
2017,Agosto,8,8/1/2017,Kazajistán,5,3,0,8
2017,Agosto,8,8/1/2017,Kenia,14,20,0,34
2017,Agosto,8,8/1/2017,Kuwait,0,4,0,4
2017,Agosto,8,8/1/2017,República de Kosovo,0,1,0,1
2017,Agosto,8,8/1/2017,Letonia,13,14,0,27
2017,Agosto,8,8/1/2017,Lituania,23,21,0,44
2017,Agosto,8,8/1/2017,Líbano,33,39,0,72
2017,Agosto,8,8/1/2017,Libia,0,1,0,1
2017,Agosto,8,8/1/2017,Liechtenstein,5,1,0,6
2017,Agosto,8,8/1/2017,Luxemburgo,15,29,0,44
2017,Agosto,8,8/1/2017,Macedonia,1,0,0,1
2017,Agosto,8,8/1/2017,Madagascar,1,3,0,4
2017,Agosto,8,8/1/2017,Malasia,19,15,0,34
2017,Agosto,8,8/1/2017,Malawi,0,3,0,3
2017,Agosto,8,8/1/2017,Malta,21,15,0,36
2017,Agosto,8,8/1/2017,Marruecos,9,21,0,30
2017,Agosto,8,8/1/2017,Mauricio,1,4,0,5
2017,Agosto,8,8/1/2017,México,6144,10495,0,16639
2017,Agosto,8,8/1/2017,República de Moldavia,3,1,0,4
2017,Agosto,8,8/1/2017,Mónaco,2,1,0,3
2017,Agosto,8,8/1/2017,Mongolia,3,0,0,3
2017,Agosto,8,8/1/2017,Montenegro,0,2,0,2
2017,Agosto,8,8/1/2017,Mozambique,1,2,0,3
2017,Agosto,8,8/1/2017,Myanmar,0,2,0,2
2017,Agosto,8,8/1/2017,Nepal,0,6,0,6
2017,Agosto,8,8/1/2017,Nicaragua,120,194,0,314
2017,Agosto,8,8/1/2017,Nigeria,6,13,0,19
2017,Agosto,8,8/1/2017,Noruega,93,149,0,242
2017,Agosto,8,8/1/2017,Nueva Zelanda,119,181,0,300
2017,Agosto,8,8/1/2017,Pakistán,4,24,0,28
2017,Agosto,8,8/1/2017,Panamá,3463,3895,0,7358
2017,Agosto,8,8/1/2017,Paraguay,448,354,0,802
2017,Agosto,8,8/1/2017,Perú,6278,7243,0,13521
2017,Agosto,8,8/1/2017,Palestina,0,5,0,5
2017,Agosto,8,8/1/2017,Polonia,164,219,0,383
2017,Agosto,8,8/1/2017,Portugal,317,621,0,938
2017,Agosto,8,8/1/2017,Reino Unido de Gran Bretaña e Irlanda del Norte,1737,2778,0,4515
2017,Agosto,8,8/1/2017,Federación de Rusia,182,213,0,395
2017,Agosto,8,8/1/2017,República Dominicana,757,1148,0,1905
2017,Agosto,8,8/1/2017,Rumania,69,85,0,154
2017,Agosto,8,8/1/2017,Rwanda,1,2,0,3
2017,Agosto,8,8/1/2017,San Cristóbal y Nevis,0,5,0,5
2017,Agosto,8,8/1/2017,San Marino,4,3,0,7
2017,Agosto,8,8/1/2017,San  Vicente y las Granadinas,2,2,0,4
2017,Agosto,8,8/1/2017,Santa Lucia,2,4,0,6
2017,Agosto,8,8/1/2017,Santa Sede/Ciudad del Vaticano,0,6,0,6
2017,Agosto,8,8/1/2017,Senegal,3,2,0,5
2017,Agosto,8,8/1/2017,Serbia,17,14,0,31
2017,Agosto,8,8/1/2017,Singapur,28,38,0,66
2017,Agosto,8,8/1/2017,República Árabe Siria,0,4,0,4
2017,Agosto,8,8/1/2017,Sri Lanka,1,1,0,2
2017,Agosto,8,8/1/2017,Sudáfrica,38,96,0,134
2017,Agosto,8,8/1/2017,Sudán,0,2,0,2
2017,Agosto,8,8/1/2017,Suecia,151,240,0,391
2017,Agosto,8,8/1/2017,Suiza,559,865,0,1424
2017,Agosto,8,8/1/2017,Surinam,12,18,0,30
2017,Agosto,8,8/1/2017,Suazilandia,2,5,0,7
2017,Agosto,8,8/1/2017,Taiwán,77,84,0,161
2017,Agosto,8,8/1/2017,Tailandia,17,12,0,29
2017,Agosto,8,8/1/2017,Tanzania,1,0,0,1
2017,Agosto,8,8/1/2017,Trinidad y Tobago,42,73,0,115
2017,Agosto,8,8/1/2017,Túnez,0,8,0,8
2017,Agosto,8,8/1/2017,Turquía,234,388,0,622
2017,Agosto,8,8/1/2017,Ucrania,20,73,0,93
2017,Agosto,8,8/1/2017,Uganda,2,2,0,4
2017,Agosto,8,8/1/2017,Uruguay,865,1040,0,1905
2017,Agosto,8,8/1/2017,Uzbekistán,1,0,0,1
2017,Agosto,8,8/1/2017,Venezuela,42358,46764,0,89122
2017,Agosto,8,8/1/2017,Vietnam,6,3,0,9
2017,Agosto,8,8/1/2017,Islas Vírgenes Británicas/Territorio Británico de Ultramar,0,1,0,1
2017,Agosto,8,8/1/2017,República Árabe de Yemen,0,3,0,3
2017,Agosto,8,8/1/2017,Zambia,1,0,0,1
2017,Agosto,8,8/1/2017,Zimbabue,1,5,0,6
2017,Agosto,8,8/1/2017,Refugiado,1,2,0,3
2017,Agosto,8,8/1/2017,Desconocido,64,125,0,189
2017,Septiembre,9,9/1/2017,Afganistán,0,1,0,1
2017,Septiembre,9,9/1/2017,Albania,1,4,0,5
2017,Septiembre,9,9/1/2017,Alemania,2008,2921,0,4929
2017,Septiembre,9,9/1/2017,Andorra,1,8,0,9
2017,Septiembre,9,9/1/2017,Angola,1,1,0,2
2017,Septiembre,9,9/1/2017,Antigua y Barbuda,2,2,0,4
2017,Septiembre,9,9/1/2017,Países Bajos,1468,2198,0,3666
2017,Septiembre,9,9/1/2017,Arabia Saudita,3,8,0,11
2017,Septiembre,9,9/1/2017,Argelia,1,7,0,8
2017,Septiembre,9,9/1/2017,Argentina,6405,7381,0,13786
2017,Septiembre,9,9/1/2017,República de Armenia,3,1,0,4
2017,Septiembre,9,9/1/2017,Aruba,2,2,0,4
2017,Septiembre,9,9/1/2017,Australia,461,727,0,1188
2017,Septiembre,9,9/1/2017,Austria,170,333,0,503
2017,Septiembre,9,9/1/2017,Azerbaiyán,2,5,0,7
2017,Septiembre,9,9/1/2017,Bahamas,17,20,0,37
2017,Septiembre,9,9/1/2017,Bangladesh,1,5,0,6
2017,Septiembre,9,9/1/2017,Barbados,12,18,0,30
2017,Septiembre,9,9/1/2017,República de Belarús,8,4,0,12
2017,Septiembre,9,9/1/2017,Bélgica,332,619,0,951
2017,Septiembre,9,9/1/2017,Belice,8,13,0,21
2017,Septiembre,9,9/1/2017,Bermudas/Territorio Británico de Ultramar,0,5,0,5
2017,Septiembre,9,9/1/2017,Bolivia,1065,1027,0,2092
2017,Septiembre,9,9/1/2017,Bosnia y Herzegovina,0,4,0,4
2017,Septiembre,9,9/1/2017,Brasil,10437,10810,0,21247
2017,Septiembre,9,9/1/2017,Bulgaria,25,32,0,57
2017,Septiembre,9,9/1/2017,Burkina Faso,0,1,0,1
2017,Septiembre,9,9/1/2017,Bután,0,1,0,1
2017,Septiembre,9,9/1/2017,Cabo Verde,1,2,0,3
2017,Septiembre,9,9/1/2017,Islas Caimán/Territorio Británico de Ultramar,4,5,0,9
2017,Septiembre,9,9/1/2017,Camboya,0,6,0,6
2017,Septiembre,9,9/1/2017,Camerún,0,3,0,3
2017,Septiembre,9,9/1/2017,Canadá,1037,1898,0,2935
2017,Septiembre,9,9/1/2017,España,3242,6848,0,10090
2017,Septiembre,9,9/1/2017,República Del Congo,0,1,0,1
2017,Septiembre,9,9/1/2017,República Democrática del Congo,1,3,0,4
2017,Septiembre,9,9/1/2017,República de Corea,189,484,0,673
2017,Septiembre,9,9/1/2017,Costa de Marfil,0,3,0,3
2017,Septiembre,9,9/1/2017,Costa Rica,1714,1807,0,3521
2017,Septiembre,9,9/1/2017,Croacia,17,105,0,122
2017,Septiembre,9,9/1/2017,Cuba,262,555,0,817
2017,Septiembre,9,9/1/2017,República Checa,85,83,0,168
2017,Septiembre,9,9/1/2017,Chile,5120,6007,0,11127
2017,Septiembre,9,9/1/2017,China,382,972,0,1354
2017,Septiembre,9,9/1/2017,Chipre,5,21,0,26
2017,Septiembre,9,9/1/2017,Dinamarca,86,184,0,270
2017,Septiembre,9,9/1/2017,Dominica,3,9,0,12
2017,Septiembre,9,9/1/2017,Ecuador,6332,8621,0,14953
2017,Septiembre,9,9/1/2017,Egipto,12,33,0,45
2017,Septiembre,9,9/1/2017,El Salvador,1049,1270,0,2319
2017,Septiembre,9,9/1/2017,Emiratos Árabes,11,23,0,34
2017,Septiembre,9,9/1/2017,Eslovaquia,42,51,0,93
2017,Septiembre,9,9/1/2017,Eslovenia,11,22,0,33
2017,Septiembre,9,9/1/2017,Estados Unidos de América,11801,22058,0,33859
2017,Septiembre,9,9/1/2017,Estonia,11,10,0,21
2017,Septiembre,9,9/1/2017,Etiopia,0,3,0,3
2017,Septiembre,9,9/1/2017,Filipinas,58,342,0,400
2017,Septiembre,9,9/1/2017,Finlandia,39,59,0,98
2017,Septiembre,9,9/1/2017,Francia,1695,2859,0,4554
2017,Septiembre,9,9/1/2017,Gabón,0,1,0,1
2017,Septiembre,9,9/1/2017,Gambia,1,0,0,1
2017,Septiembre,9,9/1/2017,Georgia,1,4,0,5
2017,Septiembre,9,9/1/2017,Ghana,1,7,0,8
2017,Septiembre,9,9/1/2017,Granada,1,3,0,4
2017,Septiembre,9,9/1/2017,Grecia,33,101,0,134
2017,Septiembre,9,9/1/2017,Guatemala,772,1129,0,1901
2017,Septiembre,9,9/1/2017,Guyana,18,30,0,48
2017,Septiembre,9,9/1/2017,Haití,11,13,0,24
2017,Septiembre,9,9/1/2017,Honduras,517,529,0,1046
2017,Septiembre,9,9/1/2017,Hong Kong,6,8,0,14
2017,Septiembre,9,9/1/2017,Hungría,58,63,0,121
2017,Septiembre,9,9/1/2017,India,84,543,0,627
2017,Septiembre,9,9/1/2017,Indonesia,18,60,0,78
2017,Septiembre,9,9/1/2017,Iraq,0,2,0,2
2017,Septiembre,9,9/1/2017,Irán,6,14,0,20
2017,Septiembre,9,9/1/2017,República de Irlanda,199,306,0,505
2017,Septiembre,9,9/1/2017,Islandia,5,15,0,20
2017,Septiembre,9,9/1/2017,Isla de Man,0,1,0,1
2017,Septiembre,9,9/1/2017,Israel,262,780,0,1042
2017,Septiembre,9,9/1/2017,Italia,957,2328,0,3285
2017,Septiembre,9,9/1/2017,Jamaica,27,61,0,88
2017,Septiembre,9,9/1/2017,Japón,176,586,0,762
2017,Septiembre,9,9/1/2017,Jordania,4,12,0,16
2017,Septiembre,9,9/1/2017,Kazajistán,3,6,0,9
2017,Septiembre,9,9/1/2017,Kenia,9,15,0,24
2017,Septiembre,9,9/1/2017,Kuwait,3,1,0,4
2017,Septiembre,9,9/1/2017,República de Kosovo,3,0,0,3
2017,Septiembre,9,9/1/2017,República Democrática Popular  Lao,2,0,0,2
2017,Septiembre,9,9/1/2017,Lesoto,1,1,0,2
2017,Septiembre,9,9/1/2017,Letonia,9,15,0,24
2017,Septiembre,9,9/1/2017,Lituania,29,25,0,54
2017,Septiembre,9,9/1/2017,Líbano,23,22,0,45
2017,Septiembre,9,9/1/2017,Liechtenstein,1,1,0,2
2017,Septiembre,9,9/1/2017,Luxemburgo,5,8,0,13
2017,Septiembre,9,9/1/2017,Macedonia,1,3,0,4
2017,Septiembre,9,9/1/2017,Madagascar,4,1,0,5
2017,Septiembre,9,9/1/2017,Malasia,12,37,0,49
2017,Septiembre,9,9/1/2017,Malawi,0,2,0,2
2017,Septiembre,9,9/1/2017,Malta,7,12,0,19
2017,Septiembre,9,9/1/2017,Marruecos,12,27,0,39
2017,Septiembre,9,9/1/2017,Mauricio,5,4,0,9
2017,Septiembre,9,9/1/2017,México,5625,9860,0,15485
2017,Septiembre,9,9/1/2017,República de Moldavia,3,3,0,6
2017,Septiembre,9,9/1/2017,Mónaco,0,1,0,1
2017,Septiembre,9,9/1/2017,Montenegro,0,6,0,6
2017,Septiembre,9,9/1/2017,Mozambique,1,5,0,6
2017,Septiembre,9,9/1/2017,Myanmar,0,3,0,3
2017,Septiembre,9,9/1/2017,Namibia,0,1,0,1
2017,Septiembre,9,9/1/2017,Nepal,5,5,0,10
2017,Septiembre,9,9/1/2017,Nicaragua,151,185,0,336
2017,Septiembre,9,9/1/2017,Nigeria,6,13,0,19
2017,Septiembre,9,9/1/2017,Noruega,135,144,0,279
2017,Septiembre,9,9/1/2017,Nueva Zelanda,121,158,0,279
2017,Septiembre,9,9/1/2017,Omán,5,3,0,8
2017,Septiembre,9,9/1/2017,Papúa Nueva Guinea,0,1,0,1
2017,Septiembre,9,9/1/2017,Pakistán,5,19,0,24
2017,Septiembre,9,9/1/2017,Panamá,5312,4569,0,9881
2017,Septiembre,9,9/1/2017,Paraguay,384,541,0,925
2017,Septiembre,9,9/1/2017,Perú,5440,6418,0,11858
2017,Septiembre,9,9/1/2017,Palestina,0,2,0,2
2017,Septiembre,9,9/1/2017,Polonia,190,243,0,433
2017,Septiembre,9,9/1/2017,Portugal,230,577,0,807
2017,Septiembre,9,9/1/2017,Puerto Rico/Territorio de Estados Unidos,2,2,0,4
2017,Septiembre,9,9/1/2017,Qatar,0,1,0,1
2017,Septiembre,9,9/1/2017,Reino Unido de Gran Bretaña e Irlanda del Norte,1194,2308,0,3502
2017,Septiembre,9,9/1/2017,Federación de Rusia,176,225,0,401
2017,Septiembre,9,9/1/2017,República Dominicana,635,848,0,1483
2017,Septiembre,9,9/1/2017,Rumania,82,96,0,178
2017,Septiembre,9,9/1/2017,Rwanda,0,5,0,5
2017,Septiembre,9,9/1/2017,San Cristóbal y Nevis,3,0,0,3
2017,Septiembre,9,9/1/2017,Samoa Occidental,0,1,0,1
2017,Septiembre,9,9/1/2017,San  Vicente y las Granadinas,0,4,0,4
2017,Septiembre,9,9/1/2017,Santa Lucia,4,3,0,7
2017,Septiembre,9,9/1/2017,Santa Sede/Ciudad del Vaticano,0,11,0,11
2017,Septiembre,9,9/1/2017,Santo Tomé y Príncipe,0,1,0,1
2017,Septiembre,9,9/1/2017,Senegal,0,2,0,2
2017,Septiembre,9,9/1/2017,Serbia,7,6,0,13
2017,Septiembre,9,9/1/2017,Sierra Leona,0,2,0,2
2017,Septiembre,9,9/1/2017,Singapur,16,34,0,50
2017,Septiembre,9,9/1/2017,República Árabe Siria,1,1,0,2
2017,Septiembre,9,9/1/2017,Sri Lanka,1,7,0,8
2017,Septiembre,9,9/1/2017,Sudáfrica,31,78,0,109
2017,Septiembre,9,9/1/2017,Suecia,148,295,0,443
2017,Septiembre,9,9/1/2017,Suiza,456,777,0,1233
2017,Septiembre,9,9/1/2017,Surinam,17,20,0,37
2017,Septiembre,9,9/1/2017,Taiwán,46,83,0,129
2017,Septiembre,9,9/1/2017,Tailandia,6,14,0,20
2017,Septiembre,9,9/1/2017,Tanzania,1,5,0,6
2017,Septiembre,9,9/1/2017,Togo,0,1,0,1
2017,Septiembre,9,9/1/2017,Tonga,1,0,0,1
2017,Septiembre,9,9/1/2017,Trinidad y Tobago,43,87,0,130
2017,Septiembre,9,9/1/2017,Túnez,1,11,0,12
2017,Septiembre,9,9/1/2017,Turquía,169,326,0,495
2017,Septiembre,9,9/1/2017,Ucrania,36,40,0,76
2017,Septiembre,9,9/1/2017,Uganda,5,5,0,10
2017,Septiembre,9,9/1/2017,Uruguay,622,823,0,1445
2017,Septiembre,9,9/1/2017,Vanuatu,0,1,0,1
2017,Septiembre,9,9/1/2017,Venezuela,37120,42194,0,79314
2017,Septiembre,9,9/1/2017,Vietnam,8,7,0,15
2017,Septiembre,9,9/1/2017,República Árabe de Yemen,0,1,0,1
2017,Septiembre,9,9/1/2017,Zambia,1,3,0,4
2017,Septiembre,9,9/1/2017,Zimbabue,2,4,0,6
2017,Septiembre,9,9/1/2017,Islas Turcas y Caicos/Territorio Británico de Ultramar,1,0,0,1
2017,Septiembre,9,9/1/2017,Refugiado,1,5,0,6
2017,Septiembre,9,9/1/2017,Desconocido,116,191,0,307
2017,Octubre,10,10/1/2017,Afganistán,1,7,0,8
2017,Octubre,10,10/1/2017,Albania,2,4,0,6
2017,Octubre,10,10/1/2017,Alemania,2197,3326,0,5523
2017,Octubre,10,10/1/2017,Andorra,3,12,0,15
2017,Octubre,10,10/1/2017,Angola,2,1,0,3
2017,Octubre,10,10/1/2017,Antigua y Barbuda,1,5,0,6
2017,Octubre,10,10/1/2017,Países Bajos,1709,2465,0,4174
2017,Octubre,10,10/1/2017,Arabia Saudita,6,9,0,15
2017,Octubre,10,10/1/2017,Argelia,2,5,0,7
2017,Octubre,10,10/1/2017,Argentina,6230,7649,0,13879
2017,Octubre,10,10/1/2017,República de Armenia,0,2,0,2
2017,Octubre,10,10/1/2017,Australia,509,804,0,1313
2017,Octubre,10,10/1/2017,Austria,208,339,0,547
2017,Octubre,10,10/1/2017,Azerbaiyán,4,8,0,12
2017,Octubre,10,10/1/2017,Bahamas,11,21,0,32
2017,Octubre,10,10/1/2017,Bahréin,1,2,0,3
2017,Octubre,10,10/1/2017,Bangladesh,11,11,0,22
2017,Octubre,10,10/1/2017,Barbados,11,15,0,26
2017,Octubre,10,10/1/2017,República de Belarús,5,3,0,8
2017,Octubre,10,10/1/2017,Bélgica,325,544,0,869
2017,Octubre,10,10/1/2017,Belice,9,21,0,30
2017,Octubre,10,10/1/2017,Benín,2,6,0,8
2017,Octubre,10,10/1/2017,Bermudas/Territorio Británico de Ultramar,1,3,0,4
2017,Octubre,10,10/1/2017,Bolivia,901,955,0,1856
2017,Octubre,10,10/1/2017,Bosnia y Herzegovina,0,5,0,5
2017,Octubre,10,10/1/2017,Botsuana,1,2,0,3
2017,Octubre,10,10/1/2017,Brasil,10873,11294,0,22167
2017,Octubre,10,10/1/2017,Brunei Darussalam,1,0,0,1
2017,Octubre,10,10/1/2017,Bulgaria,44,56,0,100
2017,Octubre,10,10/1/2017,Burkina Faso,0,3,0,3
2017,Octubre,10,10/1/2017,Burundi,0,1,0,1
2017,Octubre,10,10/1/2017,Bután,0,3,0,3
2017,Octubre,10,10/1/2017,Cabo Verde,0,3,0,3
2017,Octubre,10,10/1/2017,Islas Caimán/Territorio Británico de Ultramar,1,0,0,1
2017,Octubre,10,10/1/2017,Camboya,2,2,0,4
2017,Octubre,10,10/1/2017,Camerún,1,8,0,9
2017,Octubre,10,10/1/2017,Canadá,1330,2258,0,3588
2017,Octubre,10,10/1/2017,Chad,0,1,0,1
2017,Octubre,10,10/1/2017,España,3583,7173,0,10756
2017,Octubre,10,10/1/2017,República Del Congo,1,1,0,2
2017,Octubre,10,10/1/2017,Comoras,0,1,0,1
2017,Octubre,10,10/1/2017,República Democrática del Congo,4,5,0,9
2017,Octubre,10,10/1/2017,República de Corea,286,525,0,811
2017,Octubre,10,10/1/2017,Costa de Marfil,2,12,0,14
2017,Octubre,10,10/1/2017,Costa Rica,1447,1800,0,3247
2017,Octubre,10,10/1/2017,Croacia,23,62,0,85
2017,Octubre,10,10/1/2017,Cuba,354,658,0,1012
2017,Octubre,10,10/1/2017,República Checa,76,114,0,190
2017,Octubre,10,10/1/2017,Chile,5697,6355,0,12052
2017,Octubre,10,10/1/2017,China,480,884,0,1364
2017,Octubre,10,10/1/2017,Chipre,4,5,0,9
2017,Octubre,10,10/1/2017,Dinamarca,120,233,0,353
2017,Octubre,10,10/1/2017,República de Yibuti,0,1,0,1
2017,Octubre,10,10/1/2017,Dominica,1,2,0,3
2017,Octubre,10,10/1/2017,Ecuador,5669,8428,0,14097
2017,Octubre,10,10/1/2017,Egipto,10,33,0,43
2017,Octubre,10,10/1/2017,El Salvador,1004,1364,0,2368
2017,Octubre,10,10/1/2017,Emiratos Árabes,5,23,0,28
2017,Octubre,10,10/1/2017,Eslovaquia,36,57,0,93
2017,Octubre,10,10/1/2017,Eslovenia,24,51,0,75
2017,Octubre,10,10/1/2017,Estados Unidos de América,11817,22746,0,34563
2017,Octubre,10,10/1/2017,Estonia,13,15,0,28
2017,Octubre,10,10/1/2017,Etiopia,1,4,0,5
2017,Octubre,10,10/1/2017,Islas Fiji,0,1,0,1
2017,Octubre,10,10/1/2017,Filipinas,73,243,0,316
2017,Octubre,10,10/1/2017,Finlandia,63,102,0,165
2017,Octubre,10,10/1/2017,Francia,1910,3109,0,5019
2017,Octubre,10,10/1/2017,Gabón,0,3,0,3
2017,Octubre,10,10/1/2017,Gambia,0,1,0,1
2017,Octubre,10,10/1/2017,Georgia,7,8,0,15
2017,Octubre,10,10/1/2017,Ghana,8,28,0,36
2017,Octubre,10,10/1/2017,Granada,1,4,0,5
2017,Octubre,10,10/1/2017,Grecia,42,100,0,142
2017,Octubre,10,10/1/2017,Guatemala,735,1176,0,1911
2017,Octubre,10,10/1/2017,Guyana,12,29,0,41
2017,Octubre,10,10/1/2017,Guinea,0,2,0,2
2017,Octubre,10,10/1/2017,Guinea Ecuatorial,0,2,0,2
2017,Octubre,10,10/1/2017,Guinea Bissau,0,2,0,2
2017,Octubre,10,10/1/2017,Haití,17,30,0,47
2017,Octubre,10,10/1/2017,Honduras,439,554,0,993
2017,Octubre,10,10/1/2017,Hong Kong,6,11,0,17
2017,Octubre,10,10/1/2017,Hungría,61,100,0,161
2017,Octubre,10,10/1/2017,India,96,504,0,600
2017,Octubre,10,10/1/2017,Indonesia,10,17,0,27
2017,Octubre,10,10/1/2017,Iraq,1,0,0,1
2017,Octubre,10,10/1/2017,Irán,8,15,0,23
2017,Octubre,10,10/1/2017,República de Irlanda,176,323,0,499
2017,Octubre,10,10/1/2017,Islandia,4,9,0,13
2017,Octubre,10,10/1/2017,Israel,195,593,0,788
2017,Octubre,10,10/1/2017,Italia,899,2433,0,3332
2017,Octubre,10,10/1/2017,Jamaica,47,61,0,108
2017,Octubre,10,10/1/2017,Islas Salomón,0,1,0,1
2017,Octubre,10,10/1/2017,Japón,178,606,0,784
2017,Octubre,10,10/1/2017,Jordania,3,12,0,15
2017,Octubre,10,10/1/2017,Kazajistán,7,10,0,17
2017,Octubre,10,10/1/2017,Kenia,16,16,0,32
2017,Octubre,10,10/1/2017,Kiribati,0,1,0,1
2017,Octubre,10,10/1/2017,Kirguistán,1,1,0,2
2017,Octubre,10,10/1/2017,Kuwait,0,2,0,2
2017,Octubre,10,10/1/2017,República de Kosovo,1,0,0,1
2017,Octubre,10,10/1/2017,República Democrática Popular  Lao,1,0,0,1
2017,Octubre,10,10/1/2017,Lesoto,1,1,0,2
2017,Octubre,10,10/1/2017,Letonia,7,24,0,31
2017,Octubre,10,10/1/2017,Lituania,32,39,0,71
2017,Octubre,10,10/1/2017,Líbano,22,31,0,53
2017,Octubre,10,10/1/2017,Liberia,1,2,0,3
2017,Octubre,10,10/1/2017,Libia,1,1,0,2
2017,Octubre,10,10/1/2017,Liechtenstein,2,4,0,6
2017,Octubre,10,10/1/2017,Luxemburgo,11,12,0,23
2017,Octubre,10,10/1/2017,Macedonia,0,9,0,9
2017,Octubre,10,10/1/2017,Madagascar,3,0,0,3
2017,Octubre,10,10/1/2017,Malasia,26,37,0,63
2017,Octubre,10,10/1/2017,Malawi,1,1,0,2
2017,Octubre,10,10/1/2017,Maldivas,1,0,0,1
2017,Octubre,10,10/1/2017,Malí,1,3,0,4
2017,Octubre,10,10/1/2017,Malta,4,12,0,16
2017,Octubre,10,10/1/2017,Marruecos,15,17,0,32
2017,Octubre,10,10/1/2017,Islas Marshall,1,0,0,1
2017,Octubre,10,10/1/2017,Mauricio,2,9,0,11
2017,Octubre,10,10/1/2017,México,5924,9815,0,15739
2017,Octubre,10,10/1/2017,República de Moldavia,5,5,0,10
2017,Octubre,10,10/1/2017,Mónaco,0,1,0,1
2017,Octubre,10,10/1/2017,Mongolia,2,1,0,3
2017,Octubre,10,10/1/2017,Montenegro,3,8,0,11
2017,Octubre,10,10/1/2017,Micronesia,1,0,0,1
2017,Octubre,10,10/1/2017,Mozambique,1,4,0,5
2017,Octubre,10,10/1/2017,Myanmar,9,20,0,29
2017,Octubre,10,10/1/2017,Nauru,1,0,0,1
2017,Octubre,10,10/1/2017,Namibia,1,1,0,2
2017,Octubre,10,10/1/2017,Nepal,6,7,0,13
2017,Octubre,10,10/1/2017,Nicaragua,141,199,0,340
2017,Octubre,10,10/1/2017,Nigeria,11,21,0,32
2017,Octubre,10,10/1/2017,Noruega,134,171,0,305
2017,Octubre,10,10/1/2017,Nueva Zelanda,100,186,0,286
2017,Octubre,10,10/1/2017,Omán,1,5,0,6
2017,Octubre,10,10/1/2017,Papúa Nueva Guinea,0,2,0,2
2017,Octubre,10,10/1/2017,Pakistán,12,21,0,33
2017,Octubre,10,10/1/2017,Palau,1,0,0,1
2017,Octubre,10,10/1/2017,Panamá,3782,3994,0,7776
2017,Octubre,10,10/1/2017,Paraguay,360,417,0,777
2017,Octubre,10,10/1/2017,Perú,6733,7886,0,14619
2017,Octubre,10,10/1/2017,Palestina,2,1,0,3
2017,Octubre,10,10/1/2017,Polonia,178,259,0,437
2017,Octubre,10,10/1/2017,Portugal,306,637,0,943
2017,Octubre,10,10/1/2017,Qatar,0,2,0,2
2017,Octubre,10,10/1/2017,Reino Unido de Gran Bretaña e Irlanda del Norte,1250,2503,0,3753
2017,Octubre,10,10/1/2017,Federación de Rusia,228,321,0,549
2017,Octubre,10,10/1/2017,República Dominicana,762,944,0,1706
2017,Octubre,10,10/1/2017,Rumania,88,91,0,179
2017,Octubre,10,10/1/2017,Rwanda,1,1,0,2
2017,Octubre,10,10/1/2017,San Cristóbal y Nevis,0,10,0,10
2017,Octubre,10,10/1/2017,Samoa Occidental,0,1,0,1
2017,Octubre,10,10/1/2017,San Marino,0,2,0,2
2017,Octubre,10,10/1/2017,San  Vicente y las Granadinas,1,4,0,5
2017,Octubre,10,10/1/2017,Santa Lucia,6,4,0,10
2017,Octubre,10,10/1/2017,Santa Sede/Ciudad del Vaticano,0,1,0,1
2017,Octubre,10,10/1/2017,Santo Tomé y Príncipe,0,1,0,1
2017,Octubre,10,10/1/2017,Senegal,1,2,0,3
2017,Octubre,10,10/1/2017,Serbia,12,14,0,26
2017,Octubre,10,10/1/2017,Seychelles,1,0,0,1
2017,Octubre,10,10/1/2017,Sierra Leona,2,1,0,3
2017,Octubre,10,10/1/2017,Singapur,34,67,0,101
2017,Octubre,10,10/1/2017,República Árabe Siria,4,5,0,9
2017,Octubre,10,10/1/2017,Somalia,0,2,0,2
2017,Octubre,10,10/1/2017,Sri Lanka,1,16,0,17
2017,Octubre,10,10/1/2017,Sudáfrica,60,85,0,145
2017,Octubre,10,10/1/2017,Sudán,1,2,0,3
2017,Octubre,10,10/1/2017,Suecia,274,385,0,659
2017,Octubre,10,10/1/2017,Suiza,564,873,0,1437
2017,Octubre,10,10/1/2017,Surinam,15,22,0,37
2017,Octubre,10,10/1/2017,Suazilandia,1,0,0,1
2017,Octubre,10,10/1/2017,Taiwán,49,98,0,147
2017,Octubre,10,10/1/2017,República de Tayikistán,1,0,0,1
2017,Octubre,10,10/1/2017,Tailandia,43,39,0,82
2017,Octubre,10,10/1/2017,Tanzania,4,7,0,11
2017,Octubre,10,10/1/2017,República Democrática de Timor Oriental,0,1,0,1
2017,Octubre,10,10/1/2017,Togo,0,1,0,1
2017,Octubre,10,10/1/2017,Tonga,1,0,0,1
2017,Octubre,10,10/1/2017,Trinidad y Tobago,38,102,0,140
2017,Octubre,10,10/1/2017,Túnez,6,7,0,13
2017,Octubre,10,10/1/2017,Turkmenistán,1,0,0,1
2017,Octubre,10,10/1/2017,Turquía,192,394,0,586
2017,Octubre,10,10/1/2017,Ucrania,38,48,0,86
2017,Octubre,10,10/1/2017,Uganda,3,9,0,12
2017,Octubre,10,10/1/2017,Uruguay,651,988,0,1639
2017,Octubre,10,10/1/2017,Uzbekistán,2,1,0,3
2017,Octubre,10,10/1/2017,Vanuatu,0,1,0,1
2017,Octubre,10,10/1/2017,Venezuela,38819,45693,0,84512
2017,Octubre,10,10/1/2017,Vietnam,4,10,0,14
2017,Octubre,10,10/1/2017,República Árabe de Yemen,1,1,0,2
2017,Octubre,10,10/1/2017,Zambia,2,5,0,7
2017,Octubre,10,10/1/2017,Zimbabue,2,6,0,8
2017,Octubre,10,10/1/2017,Anguila/Territorio Británico de Ultramar,0,1,0,1
2017,Octubre,10,10/1/2017,Refugiado,0,5,0,5
2017,Octubre,10,10/1/2017,Desconocido,101,199,0,300
2017,Noviembre,11,11/1/2017,Afganistán,0,1,0,1
2017,Noviembre,11,11/1/2017,Albania,3,7,0,10
2017,Noviembre,11,11/1/2017,Alemania,2153,3412,0,5565
2017,Noviembre,11,11/1/2017,Andorra,2,10,0,12
2017,Noviembre,11,11/1/2017,Angola,0,2,0,2
2017,Noviembre,11,11/1/2017,Antigua y Barbuda,3,6,0,9
2017,Noviembre,11,11/1/2017,Países Bajos,1844,2599,0,4443
2017,Noviembre,11,11/1/2017,Arabia Saudita,0,8,0,8
2017,Noviembre,11,11/1/2017,Argelia,2,3,0,5
2017,Noviembre,11,11/1/2017,Argentina,6551,8049,0,14600
2017,Noviembre,11,11/1/2017,República de Armenia,1,2,0,3
2017,Noviembre,11,11/1/2017,Aruba,0,1,0,1
2017,Noviembre,11,11/1/2017,Australia,631,983,0,1614
2017,Noviembre,11,11/1/2017,Austria,229,404,0,633
2017,Noviembre,11,11/1/2017,Azerbaiyán,1,3,0,4
2017,Noviembre,11,11/1/2017,Bahamas,12,19,0,31
2017,Noviembre,11,11/1/2017,Bahréin,1,1,0,2
2017,Noviembre,11,11/1/2017,Bangladesh,1,2,0,3
2017,Noviembre,11,11/1/2017,Barbados,17,18,0,35
2017,Noviembre,11,11/1/2017,República de Belarús,8,15,0,23
2017,Noviembre,11,11/1/2017,Bélgica,361,676,0,1037
2017,Noviembre,11,11/1/2017,Belice,13,36,0,49
2017,Noviembre,11,11/1/2017,Bermudas/Territorio Británico de Ultramar,1,5,0,6
2017,Noviembre,11,11/1/2017,Bolivia,1207,1327,0,2534
2017,Noviembre,11,11/1/2017,Bosnia y Herzegovina,1,5,0,6
2017,Noviembre,11,11/1/2017,Brasil,10088,10830,0,20918
2017,Noviembre,11,11/1/2017,Bulgaria,41,46,0,87
2017,Noviembre,11,11/1/2017,Burkina Faso,2,0,0,2
2017,Noviembre,11,11/1/2017,Bután,2,0,0,2
2017,Noviembre,11,11/1/2017,Cabo Verde,0,2,0,2
2017,Noviembre,11,11/1/2017,Islas Caimán/Territorio Británico de Ultramar,5,4,0,9
2017,Noviembre,11,11/1/2017,Camboya,0,3,0,3
2017,Noviembre,11,11/1/2017,Camerún,2,1,0,3
2017,Noviembre,11,11/1/2017,Canadá,1520,2736,0,4256
2017,Noviembre,11,11/1/2017,España,4060,8363,0,12423
2017,Noviembre,11,11/1/2017,República Democrática del Congo,4,3,0,7
2017,Noviembre,11,11/1/2017,República de Corea,268,612,0,880
2017,Noviembre,11,11/1/2017,Costa de Marfil,1,1,0,2
2017,Noviembre,11,11/1/2017,Costa Rica,1369,1994,0,3363
2017,Noviembre,11,11/1/2017,Croacia,25,90,0,115
2017,Noviembre,11,11/1/2017,Cuba,310,618,0,928
2017,Noviembre,11,11/1/2017,República Checa,97,169,0,266
2017,Noviembre,11,11/1/2017,Chile,5351,6287,0,11638
2017,Noviembre,11,11/1/2017,China,491,1102,0,1593
2017,Noviembre,11,11/1/2017,Chipre,2,5,0,7
2017,Noviembre,11,11/1/2017,Dinamarca,143,265,0,408
2017,Noviembre,11,11/1/2017,Dominica,4,8,0,12
2017,Noviembre,11,11/1/2017,Ecuador,6868,9355,0,16223
2017,Noviembre,11,11/1/2017,Egipto,7,23,0,30
2017,Noviembre,11,11/1/2017,El Salvador,1136,1551,0,2687
2017,Noviembre,11,11/1/2017,Emiratos Árabes,5,23,0,28
2017,Noviembre,11,11/1/2017,Eslovaquia,46,63,0,109
2017,Noviembre,11,11/1/2017,Eslovenia,36,65,0,101
2017,Noviembre,11,11/1/2017,Estados Unidos de América,15004,27490,0,42494
2017,Noviembre,11,11/1/2017,Estonia,9,21,0,30
2017,Noviembre,11,11/1/2017,Etiopia,1,4,0,5
2017,Noviembre,11,11/1/2017,Filipinas,48,242,0,290
2017,Noviembre,11,11/1/2017,Finlandia,78,116,0,194
2017,Noviembre,11,11/1/2017,Francia,2141,3536,0,5677
2017,Noviembre,11,11/1/2017,Georgia,5,3,0,8
2017,Noviembre,11,11/1/2017,Ghana,1,4,0,5
2017,Noviembre,11,11/1/2017,Gibraltar/Territorio Británico de Ultramar,0,1,0,1
2017,Noviembre,11,11/1/2017,Granada,3,12,0,15
2017,Noviembre,11,11/1/2017,Grecia,42,97,0,139
2017,Noviembre,11,11/1/2017,Guatemala,951,1461,0,2412
2017,Noviembre,11,11/1/2017,Guyana,7,24,0,31
2017,Noviembre,11,11/1/2017,Guinea,0,3,0,3
2017,Noviembre,11,11/1/2017,Guinea Ecuatorial,1,1,0,2
2017,Noviembre,11,11/1/2017,Guinea Bissau,1,1,0,2
2017,Noviembre,11,11/1/2017,Haití,8,26,0,34
2017,Noviembre,11,11/1/2017,Honduras,301,410,0,711
2017,Noviembre,11,11/1/2017,Hong Kong,3,7,0,10
2017,Noviembre,11,11/1/2017,Hungría,51,62,0,113
2017,Noviembre,11,11/1/2017,India,125,565,0,690
2017,Noviembre,11,11/1/2017,Indonesia,21,59,0,80
2017,Noviembre,11,11/1/2017,Iraq,0,1,0,1
2017,Noviembre,11,11/1/2017,Irán,6,18,0,24
2017,Noviembre,11,11/1/2017,República de Irlanda,179,317,0,496
2017,Noviembre,11,11/1/2017,Islandia,6,21,0,27
2017,Noviembre,11,11/1/2017,Israel,135,547,0,682
2017,Noviembre,11,11/1/2017,Italia,989,2929,0,3918
2017,Noviembre,11,11/1/2017,Jamaica,36,56,0,92
2017,Noviembre,11,11/1/2017,Japón,164,657,0,821
2017,Noviembre,11,11/1/2017,Jordania,6,13,0,19
2017,Noviembre,11,11/1/2017,Kazajistán,15,28,0,43
2017,Noviembre,11,11/1/2017,Kenia,11,13,0,24
2017,Noviembre,11,11/1/2017,Kiribati,0,1,0,1
2017,Noviembre,11,11/1/2017,Kirguistán,1,1,0,2
2017,Noviembre,11,11/1/2017,Lesoto,1,0,0,1
2017,Noviembre,11,11/1/2017,Letonia,31,27,0,58
2017,Noviembre,11,11/1/2017,Lituania,25,41,0,66
2017,Noviembre,11,11/1/2017,Líbano,22,36,0,58
2017,Noviembre,11,11/1/2017,Libia,1,1,0,2
2017,Noviembre,11,11/1/2017,Liechtenstein,2,3,0,5
2017,Noviembre,11,11/1/2017,Luxemburgo,9,7,0,16
2017,Noviembre,11,11/1/2017,Macedonia,1,4,0,5
2017,Noviembre,11,11/1/2017,Madagascar,1,0,0,1
2017,Noviembre,11,11/1/2017,Malasia,25,33,0,58
2017,Noviembre,11,11/1/2017,Malawi,2,1,0,3
2017,Noviembre,11,11/1/2017,Malí,0,1,0,1
2017,Noviembre,11,11/1/2017,Malta,9,11,0,20
2017,Noviembre,11,11/1/2017,Marruecos,5,22,0,27
2017,Noviembre,11,11/1/2017,Mauricio,2,5,0,7
2017,Noviembre,11,11/1/2017,México,5677,10306,0,15983
2017,Noviembre,11,11/1/2017,República de Moldavia,4,1,0,5
2017,Noviembre,11,11/1/2017,Mónaco,0,2,0,2
2017,Noviembre,11,11/1/2017,Mongolia,1,3,0,4
2017,Noviembre,11,11/1/2017,Montenegro,0,11,0,11
2017,Noviembre,11,11/1/2017,Mozambique,1,5,0,6
2017,Noviembre,11,11/1/2017,Myanmar,0,1,0,1
2017,Noviembre,11,11/1/2017,Namibia,0,1,0,1
2017,Noviembre,11,11/1/2017,Nepal,3,4,0,7
2017,Noviembre,11,11/1/2017,Nicaragua,158,199,0,357
2017,Noviembre,11,11/1/2017,Nigeria,2,9,0,11
2017,Noviembre,11,11/1/2017,Noruega,166,219,0,385
2017,Noviembre,11,11/1/2017,Nueva Zelanda,102,190,0,292
2017,Noviembre,11,11/1/2017,Omán,0,3,0,3
2017,Noviembre,11,11/1/2017,Pakistán,5,21,0,26
2017,Noviembre,11,11/1/2017,Panamá,7032,6113,0,13145
2017,Noviembre,11,11/1/2017,Paraguay,483,493,0,976
2017,Noviembre,11,11/1/2017,Perú,5555,7230,0,12785
2017,Noviembre,11,11/1/2017,Palestina,1,1,0,2
2017,Noviembre,11,11/1/2017,Polonia,298,416,0,714
2017,Noviembre,11,11/1/2017,Portugal,372,654,0,1026
2017,Noviembre,11,11/1/2017,Qatar,0,2,0,2
2017,Noviembre,11,11/1/2017,Reino Unido de Gran Bretaña e Irlanda del Norte,1324,2711,0,4035
2017,Noviembre,11,11/1/2017,Federación de Rusia,186,299,0,485
2017,Noviembre,11,11/1/2017,República Dominicana,926,1230,0,2156
2017,Noviembre,11,11/1/2017,Rumania,64,102,0,166
2017,Noviembre,11,11/1/2017,San Cristóbal y Nevis,6,12,0,18
2017,Noviembre,11,11/1/2017,San  Vicente y las Granadinas,2,10,0,12
2017,Noviembre,11,11/1/2017,Santa Lucia,10,9,0,19
2017,Noviembre,11,11/1/2017,Santa Sede/Ciudad del Vaticano,0,2,0,2
2017,Noviembre,11,11/1/2017,Santo Tomé y Príncipe,0,2,0,2
2017,Noviembre,11,11/1/2017,Senegal,1,4,0,5
2017,Noviembre,11,11/1/2017,Serbia,7,27,0,34
2017,Noviembre,11,11/1/2017,Singapur,22,37,0,59
2017,Noviembre,11,11/1/2017,República Árabe Siria,2,1,0,3
2017,Noviembre,11,11/1/2017,Somalia,0,1,0,1
2017,Noviembre,11,11/1/2017,Sri Lanka,2,8,0,10
2017,Noviembre,11,11/1/2017,Sudáfrica,32,58,0,90
2017,Noviembre,11,11/1/2017,Suecia,296,434,0,730
2017,Noviembre,11,11/1/2017,Suiza,641,1035,0,1676
2017,Noviembre,11,11/1/2017,Surinam,14,23,0,37
2017,Noviembre,11,11/1/2017,Taiwán,130,117,0,247
2017,Noviembre,11,11/1/2017,República de Tayikistán,4,6,0,10
2017,Noviembre,11,11/1/2017,Tailandia,35,25,0,60
2017,Noviembre,11,11/1/2017,Tanzania,1,1,0,2
2017,Noviembre,11,11/1/2017,Togo,0,2,0,2
2017,Noviembre,11,11/1/2017,Trinidad y Tobago,36,85,0,121
2017,Noviembre,11,11/1/2017,Túnez,4,5,0,9
2017,Noviembre,11,11/1/2017,Turkmenistán,1,0,0,1
2017,Noviembre,11,11/1/2017,Turquía,173,319,0,492
2017,Noviembre,11,11/1/2017,Ucrania,37,71,0,108
2017,Noviembre,11,11/1/2017,Uganda,3,4,0,7
2017,Noviembre,11,11/1/2017,Uruguay,558,794,0,1352
2017,Noviembre,11,11/1/2017,Uzbekistán,0,1,0,1
2017,Noviembre,11,11/1/2017,Venezuela,43850,52056,0,95906
2017,Noviembre,11,11/1/2017,Vietnam,8,4,0,12
2017,Noviembre,11,11/1/2017,Islas Vírgenes Británicas/Territorio Británico de Ultramar,3,2,0,5
2017,Noviembre,11,11/1/2017,República Árabe de Yemen,0,3,0,3
2017,Noviembre,11,11/1/2017,Zimbabue,2,1,0,3
2017,Noviembre,11,11/1/2017,Refugiado,0,1,0,1
2017,Noviembre,11,11/1/2017,Desconocido,107,203,0,310
2017,Diciembre,12,12/1/2017,Albania,3,9,0,12
2017,Diciembre,12,12/1/2017,Alemania,2827,4133,0,6960
2017,Diciembre,12,12/1/2017,Andorra,3,8,0,11
2017,Diciembre,12,12/1/2017,Angola,3,2,0,5
2017,Diciembre,12,12/1/2017,Antigua y Barbuda,1,2,0,3
2017,Diciembre,12,12/1/2017,Países Bajos,1999,2970,0,4969
2017,Diciembre,12,12/1/2017,Arabia Saudita,1,24,0,25
2017,Diciembre,12,12/1/2017,Argelia,2,10,0,12
2017,Diciembre,12,12/1/2017,Argentina,7890,9248,0,17138
2017,Diciembre,12,12/1/2017,República de Armenia,2,0,0,2
2017,Diciembre,12,12/1/2017,Australia,782,1323,0,2105
2017,Diciembre,12,12/1/2017,Austria,270,449,0,719
2017,Diciembre,12,12/1/2017,Azerbaiyán,3,2,0,5
2017,Diciembre,12,12/1/2017,Bahamas,12,18,0,30
2017,Diciembre,12,12/1/2017,Bahréin,0,1,0,1
2017,Diciembre,12,12/1/2017,Bangladesh,5,3,0,8
2017,Diciembre,12,12/1/2017,Barbados,13,11,0,24
2017,Diciembre,12,12/1/2017,República de Belarús,10,7,0,17
2017,Diciembre,12,12/1/2017,Bélgica,408,729,0,1137
2017,Diciembre,12,12/1/2017,Belice,6,8,0,14
2017,Diciembre,12,12/1/2017,Benín,0,1,0,1
2017,Diciembre,12,12/1/2017,Bermudas/Territorio Británico de Ultramar,2,2,0,4
2017,Diciembre,12,12/1/2017,Bolivia,1393,1192,0,2585
2017,Diciembre,12,12/1/2017,Bosnia y Herzegovina,3,2,0,5
2017,Diciembre,12,12/1/2017,Brasil,9921,9407,0,19328
2017,Diciembre,12,12/1/2017,Brunei Darussalam,1,0,0,1
2017,Diciembre,12,12/1/2017,Bulgaria,42,42,0,84
2017,Diciembre,12,12/1/2017,Burundi,0,2,0,2
2017,Diciembre,12,12/1/2017,Bután,1,0,0,1
2017,Diciembre,12,12/1/2017,Cabo Verde,0,2,0,2
2017,Diciembre,12,12/1/2017,Islas Caimán/Territorio Británico de Ultramar,15,9,0,24
2017,Diciembre,12,12/1/2017,Camboya,2,1,0,3
2017,Diciembre,12,12/1/2017,Camerún,1,3,0,4
2017,Diciembre,12,12/1/2017,Canadá,3047,4457,0,7504
2017,Diciembre,12,12/1/2017,España,4882,8107,0,12989
2017,Diciembre,12,12/1/2017,República Del Congo,2,1,0,3
2017,Diciembre,12,12/1/2017,República Democrática del Congo,4,2,0,6
2017,Diciembre,12,12/1/2017,República de Corea,400,538,0,938
2017,Diciembre,12,12/1/2017,Costa de Marfil,0,1,0,1
2017,Diciembre,12,12/1/2017,Costa Rica,2351,2494,0,4845
2017,Diciembre,12,12/1/2017,Croacia,32,80,0,112
2017,Diciembre,12,12/1/2017,Cuba,362,657,0,1019
2017,Diciembre,12,12/1/2017,República Checa,87,114,0,201
2017,Diciembre,12,12/1/2017,Chile,4231,5332,0,9563
2017,Diciembre,12,12/1/2017,China,392,791,0,1183
2017,Diciembre,12,12/1/2017,Chipre,5,13,0,18
2017,Diciembre,12,12/1/2017,Dinamarca,212,380,0,592
2017,Diciembre,12,12/1/2017,Dominica,0,4,0,4
2017,Diciembre,12,12/1/2017,Ecuador,6905,8801,0,15706
2017,Diciembre,12,12/1/2017,Egipto,4,17,0,21
2017,Diciembre,12,12/1/2017,El Salvador,1019,1229,0,2248
2017,Diciembre,12,12/1/2017,Emiratos Árabes,2,17,0,19
2017,Diciembre,12,12/1/2017,Eslovaquia,44,57,0,101
2017,Diciembre,12,12/1/2017,Eslovenia,23,41,0,64
2017,Diciembre,12,12/1/2017,Estados Unidos de América,23272,36358,0,59630
2017,Diciembre,12,12/1/2017,Estonia,12,25,0,37
2017,Diciembre,12,12/1/2017,Etiopia,2,0,0,2
2017,Diciembre,12,12/1/2017,Islas Fiji,0,1,0,1
2017,Diciembre,12,12/1/2017,Filipinas,62,208,0,270
2017,Diciembre,12,12/1/2017,Finlandia,130,163,0,293
2017,Diciembre,12,12/1/2017,Francia,2948,4549,0,7497
2017,Diciembre,12,12/1/2017,Gabón,0,1,0,1
2017,Diciembre,12,12/1/2017,Georgia,1,3,0,4
2017,Diciembre,12,12/1/2017,Ghana,0,5,0,5
2017,Diciembre,12,12/1/2017,Granada,5,9,0,14
2017,Diciembre,12,12/1/2017,Grecia,54,119,0,173
2017,Diciembre,12,12/1/2017,Guatemala,1141,1345,0,2486
2017,Diciembre,12,12/1/2017,Guyana,7,13,0,20
2017,Diciembre,12,12/1/2017,Haití,23,27,0,50
2017,Diciembre,12,12/1/2017,Honduras,369,404,0,773
2017,Diciembre,12,12/1/2017,Hong Kong,9,8,0,17
2017,Diciembre,12,12/1/2017,Hungría,47,87,0,134
2017,Diciembre,12,12/1/2017,India,135,503,0,638
2017,Diciembre,12,12/1/2017,Indonesia,16,28,0,44
2017,Diciembre,12,12/1/2017,Iraq,0,2,0,2
2017,Diciembre,12,12/1/2017,Irán,10,17,0,27
2017,Diciembre,12,12/1/2017,República de Irlanda,154,299,0,453
2017,Diciembre,12,12/1/2017,Islandia,23,26,0,49
2017,Diciembre,12,12/1/2017,Israel,181,616,0,797
2017,Diciembre,12,12/1/2017,Italia,1361,2983,0,4344
2017,Diciembre,12,12/1/2017,Jamaica,26,50,0,76
2017,Diciembre,12,12/1/2017,Japón,308,574,0,882
2017,Diciembre,12,12/1/2017,Jordania,1,12,0,13
2017,Diciembre,12,12/1/2017,Kazajistán,11,7,0,18
2017,Diciembre,12,12/1/2017,Kenia,5,7,0,12
2017,Diciembre,12,12/1/2017,Kuwait,2,5,0,7
2017,Diciembre,12,12/1/2017,República de Kosovo,0,3,0,3
2017,Diciembre,12,12/1/2017,República Democrática Popular  Lao,1,0,0,1
2017,Diciembre,12,12/1/2017,Letonia,12,16,0,28
2017,Diciembre,12,12/1/2017,Lituania,32,33,0,65
2017,Diciembre,12,12/1/2017,Líbano,21,57,0,78
2017,Diciembre,12,12/1/2017,Libia,0,1,0,1
2017,Diciembre,12,12/1/2017,Liechtenstein,8,3,0,11
2017,Diciembre,12,12/1/2017,Luxemburgo,10,26,0,36
2017,Diciembre,12,12/1/2017,Macedonia,3,5,0,8
2017,Diciembre,12,12/1/2017,Madagascar,2,0,0,2
2017,Diciembre,12,12/1/2017,Malasia,31,24,0,55
2017,Diciembre,12,12/1/2017,Maldivas,0,1,0,1
2017,Diciembre,12,12/1/2017,Malí,0,1,0,1
2017,Diciembre,12,12/1/2017,Malta,7,23,0,30
2017,Diciembre,12,12/1/2017,Marruecos,15,23,0,38
2017,Diciembre,12,12/1/2017,Mauricio,1,2,0,3
2017,Diciembre,12,12/1/2017,Mauritania,0,1,0,1
2017,Diciembre,12,12/1/2017,México,5741,8527,0,14268
2017,Diciembre,12,12/1/2017,República de Moldavia,7,1,0,8
2017,Diciembre,12,12/1/2017,Mónaco,0,1,0,1
2017,Diciembre,12,12/1/2017,Mongolia,1,1,0,2
2017,Diciembre,12,12/1/2017,Montenegro,4,9,0,13
2017,Diciembre,12,12/1/2017,Mozambique,1,3,0,4
2017,Diciembre,12,12/1/2017,Myanmar,2,5,0,7
2017,Diciembre,12,12/1/2017,Namibia,1,1,0,2
2017,Diciembre,12,12/1/2017,Nepal,2,4,0,6
2017,Diciembre,12,12/1/2017,Nicaragua,176,162,0,338
2017,Diciembre,12,12/1/2017,Nigeria,3,5,0,8
2017,Diciembre,12,12/1/2017,Noruega,220,375,0,595
2017,Diciembre,12,12/1/2017,Nueva Zelanda,115,213,0,328
2017,Diciembre,12,12/1/2017,Omán,0,1,0,1
2017,Diciembre,12,12/1/2017,Papúa Nueva Guinea,3,3,0,6
2017,Diciembre,12,12/1/2017,Pakistán,10,20,0,30
2017,Diciembre,12,12/1/2017,Panamá,4157,4722,0,8879
2017,Diciembre,12,12/1/2017,Paraguay,297,215,0,512
2017,Diciembre,12,12/1/2017,Perú,5219,6184,0,11403
2017,Diciembre,12,12/1/2017,Palestina,2,0,0,2
2017,Diciembre,12,12/1/2017,Polonia,207,203,0,410
2017,Diciembre,12,12/1/2017,Portugal,309,606,0,915
2017,Diciembre,12,12/1/2017,Qatar,0,1,0,1
2017,Diciembre,12,12/1/2017,Reino Unido de Gran Bretaña e Irlanda del Norte,1855,3339,0,5194
2017,Diciembre,12,12/1/2017,República CentroÁfricana,0,1,0,1
2017,Diciembre,12,12/1/2017,Federación de Rusia,250,324,0,574
2017,Diciembre,12,12/1/2017,República Dominicana,662,805,0,1467
2017,Diciembre,12,12/1/2017,Rumania,111,123,0,234
2017,Diciembre,12,12/1/2017,Rwanda,1,0,0,1
2017,Diciembre,12,12/1/2017,San Cristóbal y Nevis,3,8,0,11
2017,Diciembre,12,12/1/2017,San Marino,0,1,0,1
2017,Diciembre,12,12/1/2017,San  Vicente y las Granadinas,0,4,0,4
2017,Diciembre,12,12/1/2017,Santa Lucia,4,4,0,8
2017,Diciembre,12,12/1/2017,Senegal,1,2,0,3
2017,Diciembre,12,12/1/2017,Serbia,14,22,0,36
2017,Diciembre,12,12/1/2017,Singapur,31,41,0,72
2017,Diciembre,12,12/1/2017,República Árabe Siria,2,7,0,9
2017,Diciembre,12,12/1/2017,Sri Lanka,4,4,0,8
2017,Diciembre,12,12/1/2017,Sudáfrica,53,67,0,120
2017,Diciembre,12,12/1/2017,Suecia,535,738,0,1273
2017,Diciembre,12,12/1/2017,Suiza,893,1542,0,2435
2017,Diciembre,12,12/1/2017,Surinam,3,16,0,19
2017,Diciembre,12,12/1/2017,Taiwán,91,81,0,172
2017,Diciembre,12,12/1/2017,República de Tayikistán,1,0,0,1
2017,Diciembre,12,12/1/2017,Tailandia,26,14,0,40
2017,Diciembre,12,12/1/2017,Tanzania,2,1,0,3
2017,Diciembre,12,12/1/2017,Tonga,1,0,0,1
2017,Diciembre,12,12/1/2017,Trinidad y Tobago,52,83,0,135
2017,Diciembre,12,12/1/2017,Túnez,4,17,0,21
2017,Diciembre,12,12/1/2017,Turkmenistán,1,0,0,1
2017,Diciembre,12,12/1/2017,Turquía,178,350,0,528
2017,Diciembre,12,12/1/2017,Ucrania,54,87,0,141
2017,Diciembre,12,12/1/2017,Uganda,4,2,0,6
2017,Diciembre,12,12/1/2017,Uruguay,465,637,0,1102
2017,Diciembre,12,12/1/2017,Uzbekistán,1,0,0,1
2017,Diciembre,12,12/1/2017,Venezuela,53226,56423,0,109649
2017,Diciembre,12,12/1/2017,Vietnam,14,4,0,18
2017,Diciembre,12,12/1/2017,Islas Vírgenes Británicas/Territorio Británico de Ultramar,1,0,0,1
2017,Diciembre,12,12/1/2017,República Árabe de Yemen,0,3,0,3
2017,Diciembre,12,12/1/2017,Zambia,1,4,0,5
2017,Diciembre,12,12/1/2017,Zimbabue,1,9,0,10
2017,Diciembre,12,12/1/2017,Refugiado,1,12,0,13
2017,Diciembre,12,12/1/2017,Desconocido,57,129,0,186
2018,Enero,1,1/1/2018,Afganistán,1,1,0,2
2018,Enero,1,1/1/2018,Albania,2,11,0,13
2018,Enero,1,1/1/2018,Alemania,2643,3780,0,6423
2018,Enero,1,1/1/2018,Andorra,3,12,0,15
2018,Enero,1,1/1/2018,Angola,0,2,0,2
2018,Enero,1,1/1/2018,Antigua y Barbuda,1,1,0,2
2018,Enero,1,1/1/2018,Países Bajos,1863,2491,0,4354
2018,Enero,1,1/1/2018,Arabia Saudita,0,16,0,16
2018,Enero,1,1/1/2018,Argelia,5,9,0,14
2018,Enero,1,1/1/2018,Argentina,14258,12730,0,26988
2018,Enero,1,1/1/2018,República de Armenia,2,2,0,4
2018,Enero,1,1/1/2018,Aruba,1,0,0,1
2018,Enero,1,1/1/2018,Australia,636,1109,0,1745
2018,Enero,1,1/1/2018,Austria,307,477,0,784
2018,Enero,1,1/1/2018,Azerbaiyán,3,5,0,8
2018,Enero,1,1/1/2018,Bahamas,8,21,0,29
2018,Enero,1,1/1/2018,Bahréin,1,0,0,1
2018,Enero,1,1/1/2018,Bangladesh,0,4,0,4
2018,Enero,1,1/1/2018,Barbados,7,18,0,25
2018,Enero,1,1/1/2018,República de Belarús,6,6,0,12
2018,Enero,1,1/1/2018,Bélgica,413,687,0,1100
2018,Enero,1,1/1/2018,Belice,7,13,0,20
2018,Enero,1,1/1/2018,Bermudas/Territorio Británico de Ultramar,0,1,0,1
2018,Enero,1,1/1/2018,Bolivia,1259,1141,0,2400
2018,Enero,1,1/1/2018,Bosnia y Herzegovina,3,3,0,6
2018,Enero,1,1/1/2018,Brasil,10983,10505,0,21488
2018,Enero,1,1/1/2018,Bulgaria,54,76,0,130
2018,Enero,1,1/1/2018,Bután,1,0,0,1
2018,Enero,1,1/1/2018,Cabo Verde,0,5,0,5
2018,Enero,1,1/1/2018,Islas Caimán/Territorio Británico de Ultramar,0,3,0,3
2018,Enero,1,1/1/2018,Camerún,0,2,0,2
2018,Enero,1,1/1/2018,Canadá,3031,4253,0,7284
2018,Enero,1,1/1/2018,España,3970,7421,0,11391
2018,Enero,1,1/1/2018,República Democrática del Congo,3,6,0,9
2018,Enero,1,1/1/2018,República de Corea,537,708,0,1245
2018,Enero,1,1/1/2018,Costa de Marfil,1,3,0,4
2018,Enero,1,1/1/2018,Costa Rica,2453,2296,0,4749
2018,Enero,1,1/1/2018,Croacia,48,95,0,143
2018,Enero,1,1/1/2018,Cuba,978,1051,0,2029
2018,Enero,1,1/1/2018,República Checa,112,154,0,266
2018,Enero,1,1/1/2018,Chile,5066,5597,0,10663
2018,Enero,1,1/1/2018,China,492,864,0,1356
2018,Enero,1,1/1/2018,Chipre,9,8,0,17
2018,Enero,1,1/1/2018,Dinamarca,260,370,0,630
2018,Enero,1,1/1/2018,Dominica,7,8,0,15
2018,Enero,1,1/1/2018,Ecuador,4899,7198,0,12097
2018,Enero,1,1/1/2018,Egipto,6,32,0,38
2018,Enero,1,1/1/2018,El Salvador,946,1188,0,2134
2018,Enero,1,1/1/2018,Emiratos Árabes,1,14,0,15
2018,Enero,1,1/1/2018,Eslovaquia,63,87,0,150
2018,Enero,1,1/1/2018,Eslovenia,47,67,0,114
2018,Enero,1,1/1/2018,Estados Unidos de América,15255,26503,0,41758
2018,Enero,1,1/1/2018,Estonia,21,39,0,60
2018,Enero,1,1/1/2018,Etiopia,1,5,0,6
2018,Enero,1,1/1/2018,Filipinas,74,223,0,297
2018,Enero,1,1/1/2018,Finlandia,116,107,0,223
2018,Enero,1,1/1/2018,Francia,3565,4923,0,8488
2018,Enero,1,1/1/2018,Georgia,3,4,0,7
2018,Enero,1,1/1/2018,Ghana,2,16,0,18
2018,Enero,1,1/1/2018,Granada,1,2,0,3
2018,Enero,1,1/1/2018,Grecia,40,90,0,130
2018,Enero,1,1/1/2018,Guatemala,615,973,0,1588
2018,Enero,1,1/1/2018,Guyana,7,14,0,21
2018,Enero,1,1/1/2018,Haití,10,26,0,36
2018,Enero,1,1/1/2018,Honduras,343,430,0,773
2018,Enero,1,1/1/2018,Hong Kong,8,9,0,17
2018,Enero,1,1/1/2018,Hungría,84,132,0,216
2018,Enero,1,1/1/2018,India,123,566,0,689
2018,Enero,1,1/1/2018,Indonesia,18,40,0,58
2018,Enero,1,1/1/2018,Iraq,0,2,0,2
2018,Enero,1,1/1/2018,Irán,10,15,0,25
2018,Enero,1,1/1/2018,República de Irlanda,178,330,0,508
2018,Enero,1,1/1/2018,Islandia,17,15,0,32
2018,Enero,1,1/1/2018,Israel,219,753,0,972
2018,Enero,1,1/1/2018,Italia,1277,3077,0,4354
2018,Enero,1,1/1/2018,Jamaica,43,49,0,92
2018,Enero,1,1/1/2018,Japón,252,568,0,820
2018,Enero,1,1/1/2018,Jordania,2,6,0,8
2018,Enero,1,1/1/2018,Kazajistán,5,8,0,13
2018,Enero,1,1/1/2018,Kenia,7,11,0,18
2018,Enero,1,1/1/2018,Kirguistán,2,1,0,3
2018,Enero,1,1/1/2018,Kuwait,0,7,0,7
2018,Enero,1,1/1/2018,República de Kosovo,0,1,0,1
2018,Enero,1,1/1/2018,República Democrática Popular  Lao,1,0,0,1
2018,Enero,1,1/1/2018,Letonia,22,30,0,52
2018,Enero,1,1/1/2018,Lituania,24,48,0,72
2018,Enero,1,1/1/2018,Líbano,13,27,0,40
2018,Enero,1,1/1/2018,Liberia,1,0,0,1
2018,Enero,1,1/1/2018,Libia,0,2,0,2
2018,Enero,1,1/1/2018,Liechtenstein,3,3,0,6
2018,Enero,1,1/1/2018,Luxemburgo,17,18,0,35
2018,Enero,1,1/1/2018,Macedonia,0,2,0,2
2018,Enero,1,1/1/2018,Madagascar,2,1,0,3
2018,Enero,1,1/1/2018,Malasia,17,26,0,43
2018,Enero,1,1/1/2018,Malawi,0,1,0,1
2018,Enero,1,1/1/2018,Malí,0,2,0,2
2018,Enero,1,1/1/2018,Malta,7,14,0,21
2018,Enero,1,1/1/2018,Marruecos,15,19,0,34
2018,Enero,1,1/1/2018,Mauricio,1,3,0,4
2018,Enero,1,1/1/2018,México,4681,7903,0,12584
2018,Enero,1,1/1/2018,República de Moldavia,6,0,0,6
2018,Enero,1,1/1/2018,Mónaco,1,4,0,5
2018,Enero,1,1/1/2018,Mongolia,4,2,0,6
2018,Enero,1,1/1/2018,Montenegro,5,5,0,10
2018,Enero,1,1/1/2018,Mozambique,1,4,0,5
2018,Enero,1,1/1/2018,Myanmar,0,4,0,4
2018,Enero,1,1/1/2018,Nepal,2,2,0,4
2018,Enero,1,1/1/2018,Nicaragua,180,163,0,343
2018,Enero,1,1/1/2018,Nigeria,6,9,0,15
2018,Enero,1,1/1/2018,Níger,0,1,0,1
2018,Enero,1,1/1/2018,Noruega,269,307,0,576
2018,Enero,1,1/1/2018,Nueva Zelanda,130,183,0,313
2018,Enero,1,1/1/2018,Omán,0,1,0,1
2018,Enero,1,1/1/2018,Papúa Nueva Guinea,0,1,0,1
2018,Enero,1,1/1/2018,Pakistán,5,23,0,28
2018,Enero,1,1/1/2018,Panamá,5172,4181,0,9353
2018,Enero,1,1/1/2018,Paraguay,480,345,0,825
2018,Enero,1,1/1/2018,Perú,5351,6446,0,11797
2018,Enero,1,1/1/2018,Palestina,2,2,0,4
2018,Enero,1,1/1/2018,Polonia,277,381,0,658
2018,Enero,1,1/1/2018,Portugal,375,742,0,1117
2018,Enero,1,1/1/2018,Puerto Rico/Territorio de Estados Unidos,1,0,0,1
2018,Enero,1,1/1/2018,Reino Unido de Gran Bretaña e Irlanda del Norte,1654,2858,0,4512
2018,Enero,1,1/1/2018,Federación de Rusia,335,374,0,709
2018,Enero,1,1/1/2018,República Dominicana,694,839,0,1533
2018,Enero,1,1/1/2018,Rumania,111,125,0,236
2018,Enero,1,1/1/2018,Rwanda,0,1,0,1
2018,Enero,1,1/1/2018,San Cristóbal y Nevis,4,5,0,9
2018,Enero,1,1/1/2018,San Marino,1,1,0,2
2018,Enero,1,1/1/2018,San  Vicente y las Granadinas,3,5,0,8
2018,Enero,1,1/1/2018,Santa Lucia,4,4,0,8
2018,Enero,1,1/1/2018,Santa Sede/Ciudad del Vaticano,0,1,0,1
2018,Enero,1,1/1/2018,Senegal,0,2,0,2
2018,Enero,1,1/1/2018,Serbia,9,31,0,40
2018,Enero,1,1/1/2018,Singapur,32,41,0,73
2018,Enero,1,1/1/2018,República Árabe Siria,1,2,0,3
2018,Enero,1,1/1/2018,Sri Lanka,2,13,0,15
2018,Enero,1,1/1/2018,Sudáfrica,36,55,0,91
2018,Enero,1,1/1/2018,Suecia,496,643,0,1139
2018,Enero,1,1/1/2018,Suiza,813,1174,0,1987
2018,Enero,1,1/1/2018,Surinam,8,31,0,39
2018,Enero,1,1/1/2018,Taiwán,66,96,0,162
2018,Enero,1,1/1/2018,Tailandia,22,20,0,42
2018,Enero,1,1/1/2018,Tanzania,1,0,0,1
2018,Enero,1,1/1/2018,Togo,0,1,0,1
2018,Enero,1,1/1/2018,Trinidad y Tobago,35,60,0,95
2018,Enero,1,1/1/2018,Túnez,22,22,0,44
2018,Enero,1,1/1/2018,Turquía,206,442,0,648
2018,Enero,1,1/1/2018,Ucrania,50,56,0,106
2018,Enero,1,1/1/2018,Uganda,1,2,0,3
2018,Enero,1,1/1/2018,Uruguay,653,733,0,1386
2018,Enero,1,1/1/2018,Uzbekistán,2,0,0,2
2018,Enero,1,1/1/2018,Venezuela,54516,72457,0,126973
2018,Enero,1,1/1/2018,Vietnam,4,9,0,13
2018,Enero,1,1/1/2018,República Árabe de Yemen,0,1,0,1
2018,Enero,1,1/1/2018,Zimbabue,0,3,0,3
2018,Enero,1,1/1/2018,Islas Turcas y Caicos/Territorio Británico de Ultramar,0,1,0,1
2018,Enero,1,1/1/2018,Refugiado Otro,0,1,0,1
2018,Enero,1,1/1/2018,Refugiado,5,5,0,10
2018,Enero,1,1/1/2018,Desconocido,59,122,0,181
2018,Febrero,2,2/1/2018,Albania,1,2,0,3
2018,Febrero,2,2/1/2018,Alemania,3081,4160,0,7241
2018,Febrero,2,2/1/2018,Andorra,4,13,0,17
2018,Febrero,2,2/1/2018,Angola,4,3,0,7
2018,Febrero,2,2/1/2018,Antigua y Barbuda,2,1,0,3
2018,Febrero,2,2/1/2018,Países Bajos,1874,2571,0,4445
2018,Febrero,2,2/1/2018,Arabia Saudita,0,8,0,8
2018,Febrero,2,2/1/2018,Argelia,1,6,0,7
2018,Febrero,2,2/1/2018,Argentina,10923,11137,0,22060
2018,Febrero,2,2/1/2018,República de Armenia,2,1,0,3
2018,Febrero,2,2/1/2018,Australia,436,774,0,1210
2018,Febrero,2,2/1/2018,Austria,395,481,0,876
2018,Febrero,2,2/1/2018,Azerbaiyán,2,6,0,8
2018,Febrero,2,2/1/2018,Bahamas,11,28,0,39
2018,Febrero,2,2/1/2018,Bahréin,0,2,0,2
2018,Febrero,2,2/1/2018,Bangladesh,1,0,0,1
2018,Febrero,2,2/1/2018,Barbados,8,11,0,19
2018,Febrero,2,2/1/2018,República de Belarús,6,6,0,12
2018,Febrero,2,2/1/2018,Bélgica,368,598,0,966
2018,Febrero,2,2/1/2018,Belice,2,14,0,16
2018,Febrero,2,2/1/2018,Bermudas/Territorio Británico de Ultramar,2,1,0,3
2018,Febrero,2,2/1/2018,Bolivia,857,792,0,1649
2018,Febrero,2,2/1/2018,Bosnia y Herzegovina,0,7,0,7
2018,Febrero,2,2/1/2018,Botsuana,1,1,0,2
2018,Febrero,2,2/1/2018,Brasil,9359,9363,0,18722
2018,Febrero,2,2/1/2018,Bulgaria,55,56,0,111
2018,Febrero,2,2/1/2018,Burkina Faso,1,6,0,7
2018,Febrero,2,2/1/2018,Bután,0,1,0,1
2018,Febrero,2,2/1/2018,Islas Caimán/Territorio Británico de Ultramar,2,4,0,6
2018,Febrero,2,2/1/2018,Camerún,1,6,0,7
2018,Febrero,2,2/1/2018,Canadá,3063,4331,0,7394
2018,Febrero,2,2/1/2018,Chad,1,0,0,1
2018,Febrero,2,2/1/2018,España,3646,7073,0,10719
2018,Febrero,2,2/1/2018,República Democrática del Congo,0,5,0,5
2018,Febrero,2,2/1/2018,República de Corea,289,458,0,747
2018,Febrero,2,2/1/2018,Costa de Marfil,0,4,0,4
2018,Febrero,2,2/1/2018,Costa Rica,1400,1726,0,3126
2018,Febrero,2,2/1/2018,Croacia,25,80,0,105
2018,Febrero,2,2/1/2018,Cuba,1105,873,0,1978
2018,Febrero,2,2/1/2018,República Checa,110,168,0,278
2018,Febrero,2,2/1/2018,Chile,8195,7770,0,15965
2018,Febrero,2,2/1/2018,China,506,694,0,1200
2018,Febrero,2,2/1/2018,Chipre,14,13,0,27
2018,Febrero,2,2/1/2018,Dinamarca,243,347,0,590
2018,Febrero,2,2/1/2018,Dominica,3,10,0,13
2018,Febrero,2,2/1/2018,Ecuador,5446,7382,0,12828
2018,Febrero,2,2/1/2018,Egipto,2,41,0,43
2018,Febrero,2,2/1/2018,El Salvador,1041,1227,0,2268
2018,Febrero,2,2/1/2018,Emiratos Árabes,3,12,0,15
2018,Febrero,2,2/1/2018,Eritrea,1,0,0,1
2018,Febrero,2,2/1/2018,Eslovaquia,53,102,0,155
2018,Febrero,2,2/1/2018,Eslovenia,31,45,0,76
2018,Febrero,2,2/1/2018,Estados Unidos de América,18798,31298,0,50096
2018,Febrero,2,2/1/2018,Estonia,22,18,0,40
2018,Febrero,2,2/1/2018,Etiopia,2,6,0,8
2018,Febrero,2,2/1/2018,Islas Fiji,0,2,0,2
2018,Febrero,2,2/1/2018,Filipinas,57,230,0,287
2018,Febrero,2,2/1/2018,Finlandia,106,129,0,235
2018,Febrero,2,2/1/2018,Francia,3746,4852,0,8598
2018,Febrero,2,2/1/2018,Georgia,1,12,0,13
2018,Febrero,2,2/1/2018,Ghana,6,15,0,21
2018,Febrero,2,2/1/2018,Granada,1,4,0,5
2018,Febrero,2,2/1/2018,Grecia,47,121,0,168
2018,Febrero,2,2/1/2018,Guatemala,968,1353,0,2321
2018,Febrero,2,2/1/2018,Guyana,11,13,0,24
2018,Febrero,2,2/1/2018,Haití,32,44,0,76
2018,Febrero,2,2/1/2018,Honduras,483,505,0,988
2018,Febrero,2,2/1/2018,Hong Kong,10,15,0,25
2018,Febrero,2,2/1/2018,Hungría,49,92,0,141
2018,Febrero,2,2/1/2018,India,99,498,0,597
2018,Febrero,2,2/1/2018,Indonesia,25,59,0,84
2018,Febrero,2,2/1/2018,Iraq,0,2,0,2
2018,Febrero,2,2/1/2018,Irán,2,16,0,18
2018,Febrero,2,2/1/2018,República de Irlanda,137,283,0,420
2018,Febrero,2,2/1/2018,Islandia,22,36,0,58
2018,Febrero,2,2/1/2018,Israel,322,1010,0,1332
2018,Febrero,2,2/1/2018,Islas Aland/Provincia de Finlandia,0,1,0,1
2018,Febrero,2,2/1/2018,Italia,1234,2764,0,3998
2018,Febrero,2,2/1/2018,Jamaica,52,60,0,112
2018,Febrero,2,2/1/2018,Islas Salomón,0,1,0,1
2018,Febrero,2,2/1/2018,Japón,271,684,0,955
2018,Febrero,2,2/1/2018,Jordania,1,10,0,11
2018,Febrero,2,2/1/2018,Kazajistán,9,5,0,14
2018,Febrero,2,2/1/2018,Kenia,10,10,0,20
2018,Febrero,2,2/1/2018,Kiribati,0,5,0,5
2018,Febrero,2,2/1/2018,Kirguistán,1,1,0,2
2018,Febrero,2,2/1/2018,Kuwait,0,6,0,6
2018,Febrero,2,2/1/2018,República de Kosovo,0,2,0,2
2018,Febrero,2,2/1/2018,Letonia,15,25,0,40
2018,Febrero,2,2/1/2018,Lituania,55,48,0,103
2018,Febrero,2,2/1/2018,Líbano,24,31,0,55
2018,Febrero,2,2/1/2018,Liechtenstein,1,1,0,2
2018,Febrero,2,2/1/2018,Luxemburgo,12,22,0,34
2018,Febrero,2,2/1/2018,Macedonia,0,4,0,4
2018,Febrero,2,2/1/2018,Madagascar,1,0,0,1
2018,Febrero,2,2/1/2018,Malasia,27,22,0,49
2018,Febrero,2,2/1/2018,Malawi,3,1,0,4
2018,Febrero,2,2/1/2018,Malí,0,1,0,1
2018,Febrero,2,2/1/2018,Malta,8,17,0,25
2018,Febrero,2,2/1/2018,Marruecos,13,19,0,32
2018,Febrero,2,2/1/2018,Mauricio,0,2,0,2
2018,Febrero,2,2/1/2018,México,4571,8685,0,13256
2018,Febrero,2,2/1/2018,República de Moldavia,2,1,0,3
2018,Febrero,2,2/1/2018,Mónaco,0,1,0,1
2018,Febrero,2,2/1/2018,Mongolia,1,0,0,1
2018,Febrero,2,2/1/2018,Montenegro,2,7,0,9
2018,Febrero,2,2/1/2018,Mozambique,2,1,0,3
2018,Febrero,2,2/1/2018,Myanmar,1,6,0,7
2018,Febrero,2,2/1/2018,Namibia,0,1,0,1
2018,Febrero,2,2/1/2018,Nepal,1,6,0,7
2018,Febrero,2,2/1/2018,Nicaragua,159,154,0,313
2018,Febrero,2,2/1/2018,Nigeria,7,14,0,21
2018,Febrero,2,2/1/2018,Noruega,182,235,0,417
2018,Febrero,2,2/1/2018,Nueva Zelanda,75,111,0,186
2018,Febrero,2,2/1/2018,Pakistán,7,22,0,29
2018,Febrero,2,2/1/2018,Panamá,6879,5818,0,12697
2018,Febrero,2,2/1/2018,Paraguay,353,456,0,809
2018,Febrero,2,2/1/2018,Perú,6132,6917,0,13049
2018,Febrero,2,2/1/2018,Palestina,3,6,0,9
2018,Febrero,2,2/1/2018,Polonia,286,342,0,628
2018,Febrero,2,2/1/2018,Portugal,288,578,0,866
2018,Febrero,2,2/1/2018,Puerto Rico/Territorio de Estados Unidos,2,0,0,2
2018,Febrero,2,2/1/2018,Qatar,0,1,0,1
2018,Febrero,2,2/1/2018,Reino Unido de Gran Bretaña e Irlanda del Norte,1558,2714,0,4272
2018,Febrero,2,2/1/2018,Federación de Rusia,208,286,0,494
2018,Febrero,2,2/1/2018,República Dominicana,771,1100,0,1871
2018,Febrero,2,2/1/2018,Rumania,101,134,0,235
2018,Febrero,2,2/1/2018,Rwanda,0,2,0,2
2018,Febrero,2,2/1/2018,San Cristóbal y Nevis,3,3,0,6
2018,Febrero,2,2/1/2018,Samoa Estadounidense/Territorio no incorporado de Estados Unidos,1,0,0,1
2018,Febrero,2,2/1/2018,San Marino,0,2,0,2
2018,Febrero,2,2/1/2018,San  Vicente y las Granadinas,0,2,0,2
2018,Febrero,2,2/1/2018,Santa Lucia,0,6,0,6
2018,Febrero,2,2/1/2018,Senegal,2,2,0,4
2018,Febrero,2,2/1/2018,Serbia,15,26,0,41
2018,Febrero,2,2/1/2018,Singapur,21,12,0,33
2018,Febrero,2,2/1/2018,República Árabe Siria,1,9,0,10
2018,Febrero,2,2/1/2018,Sri Lanka,4,11,0,15
2018,Febrero,2,2/1/2018,Sudáfrica,18,43,0,61
2018,Febrero,2,2/1/2018,Suecia,421,546,0,967
2018,Febrero,2,2/1/2018,Suiza,817,1126,0,1943
2018,Febrero,2,2/1/2018,Surinam,8,16,0,24
2018,Febrero,2,2/1/2018,Taiwán,109,105,0,214
2018,Febrero,2,2/1/2018,Tailandia,6,9,0,15
2018,Febrero,2,2/1/2018,Tanzania,1,1,0,2
2018,Febrero,2,2/1/2018,Tonga,0,1,0,1
2018,Febrero,2,2/1/2018,Trinidad y Tobago,28,65,0,93
2018,Febrero,2,2/1/2018,Túnez,0,12,0,12
2018,Febrero,2,2/1/2018,Turquía,190,394,0,584
2018,Febrero,2,2/1/2018,Ucrania,42,54,0,96
2018,Febrero,2,2/1/2018,Uganda,3,1,0,4
2018,Febrero,2,2/1/2018,Uruguay,596,785,0,1381
2018,Febrero,2,2/1/2018,Uzbekistán,0,1,0,1
2018,Febrero,2,2/1/2018,Venezuela,55554,73118,0,128672
2018,Febrero,2,2/1/2018,Vietnam,4,4,0,8
2018,Febrero,2,2/1/2018,Islas Vírgenes Británicas/Territorio Británico de Ultramar,1,1,0,2
2018,Febrero,2,2/1/2018,República Árabe de Yemen,0,2,0,2
2018,Febrero,2,2/1/2018,Zimbabue,1,2,0,3
2018,Febrero,2,2/1/2018,Refugiado Otro,0,5,0,5
2018,Febrero,2,2/1/2018,Refugiado,3,6,0,9
2018,Febrero,2,2/1/2018,Desconocido,62,142,0,204
2018,Marzo,3,3/1/2018,Afganistán,1,4,0,5
2018,Marzo,3,3/1/2018,Albania,5,4,0,9
2018,Marzo,3,3/1/2018,Alemania,3331,4502,2,7835
2018,Marzo,3,3/1/2018,Andorra,2,8,0,10
2018,Marzo,3,3/1/2018,Angola,3,1,0,4
2018,Marzo,3,3/1/2018,Antigua y Barbuda,4,10,0,14
2018,Marzo,3,3/1/2018,Países Bajos,2113,2710,0,4823
2018,Marzo,3,3/1/2018,Arabia Saudita,1,10,0,11
2018,Marzo,3,3/1/2018,Argelia,2,6,0,8
2018,Marzo,3,3/1/2018,Argentina,13470,12891,1,26362
2018,Marzo,3,3/1/2018,República de Armenia,1,1,0,2
2018,Marzo,3,3/1/2018,Australia,451,818,0,1269
2018,Marzo,3,3/1/2018,Austria,266,459,0,725
2018,Marzo,3,3/1/2018,Azerbaiyán,5,6,0,11
2018,Marzo,3,3/1/2018,Bahamas,9,24,0,33
2018,Marzo,3,3/1/2018,Bahréin,1,4,0,5
2018,Marzo,3,3/1/2018,Bangladesh,4,5,0,9
2018,Marzo,3,3/1/2018,Barbados,6,9,0,15
2018,Marzo,3,3/1/2018,República de Belarús,3,7,0,10
2018,Marzo,3,3/1/2018,Bélgica,408,645,0,1053
2018,Marzo,3,3/1/2018,Belice,16,26,0,42
2018,Marzo,3,3/1/2018,Benín,2,3,0,5
2018,Marzo,3,3/1/2018,Bermudas/Territorio Británico de Ultramar,3,8,0,11
2018,Marzo,3,3/1/2018,Bolivia,711,783,2,1496
2018,Marzo,3,3/1/2018,Bosnia y Herzegovina,5,6,0,11
2018,Marzo,3,3/1/2018,Botsuana,1,0,0,1
2018,Marzo,3,3/1/2018,Brasil,9196,8981,0,18177
2018,Marzo,3,3/1/2018,Bulgaria,45,66,0,111
2018,Marzo,3,3/1/2018,Burkina Faso,2,2,0,4
2018,Marzo,3,3/1/2018,Burundi,1,0,0,1
2018,Marzo,3,3/1/2018,Bután,0,2,0,2
2018,Marzo,3,3/1/2018,Cabo Verde,0,1,0,1
2018,Marzo,3,3/1/2018,Islas Caimán/Territorio Británico de Ultramar,2,3,0,5
2018,Marzo,3,3/1/2018,Camboya,2,0,0,2
2018,Marzo,3,3/1/2018,Camerún,4,6,0,10
2018,Marzo,3,3/1/2018,Canadá,3242,4263,0,7505
2018,Marzo,3,3/1/2018,Chad,0,3,0,3
2018,Marzo,3,3/1/2018,España,4695,7780,0,12475
2018,Marzo,3,3/1/2018,Comoras,0,1,0,1
2018,Marzo,3,3/1/2018,República Democrática del Congo,2,5,0,7
2018,Marzo,3,3/1/2018,República de Corea,300,526,0,826
2018,Marzo,3,3/1/2018,Costa de Marfil,3,4,0,7
2018,Marzo,3,3/1/2018,Costa Rica,1837,2130,0,3967
2018,Marzo,3,3/1/2018,Croacia,39,75,0,114
2018,Marzo,3,3/1/2018,Cuba,688,698,0,1386
2018,Marzo,3,3/1/2018,República Checa,108,155,0,263
2018,Marzo,3,3/1/2018,Chile,5005,6066,0,11071
2018,Marzo,3,3/1/2018,China,567,1188,0,1755
2018,Marzo,3,3/1/2018,Chipre,10,12,0,22
2018,Marzo,3,3/1/2018,Dinamarca,246,413,0,659
2018,Marzo,3,3/1/2018,Dominica,7,9,0,16
2018,Marzo,3,3/1/2018,Ecuador,6771,8383,0,15154
2018,Marzo,3,3/1/2018,Egipto,8,28,0,36
2018,Marzo,3,3/1/2018,El Salvador,1236,1378,0,2614
2018,Marzo,3,3/1/2018,Emiratos Árabes,2,20,0,22
2018,Marzo,3,3/1/2018,Eritrea,1,1,0,2
2018,Marzo,3,3/1/2018,Eslovaquia,46,76,0,122
2018,Marzo,3,3/1/2018,Eslovenia,53,78,0,131
2018,Marzo,3,3/1/2018,Estados Unidos de América,24215,34902,0,59117
2018,Marzo,3,3/1/2018,Estonia,29,34,0,63
2018,Marzo,3,3/1/2018,Etiopia,3,8,0,11
2018,Marzo,3,3/1/2018,Islas Fiji,1,3,0,4
2018,Marzo,3,3/1/2018,Filipinas,64,296,0,360
2018,Marzo,3,3/1/2018,Finlandia,84,104,0,188
2018,Marzo,3,3/1/2018,Francia,3206,4422,0,7628
2018,Marzo,3,3/1/2018,Georgia,5,2,0,7
2018,Marzo,3,3/1/2018,Ghana,11,15,0,26
2018,Marzo,3,3/1/2018,Granada,3,7,0,10
2018,Marzo,3,3/1/2018,Grecia,52,135,0,187
2018,Marzo,3,3/1/2018,Guatemala,798,1241,0,2039
2018,Marzo,3,3/1/2018,Guyana,11,20,0,31
2018,Marzo,3,3/1/2018,Guinea,0,1,0,1
2018,Marzo,3,3/1/2018,Guinea Bissau,0,2,0,2
2018,Marzo,3,3/1/2018,Haití,15,29,0,44
2018,Marzo,3,3/1/2018,Honduras,519,524,0,1043
2018,Marzo,3,3/1/2018,Hong Kong,15,11,0,26
2018,Marzo,3,3/1/2018,Hungría,75,89,0,164
2018,Marzo,3,3/1/2018,India,157,579,1,737
2018,Marzo,3,3/1/2018,Indonesia,21,56,0,77
2018,Marzo,3,3/1/2018,Iraq,1,3,0,4
2018,Marzo,3,3/1/2018,Irán,8,17,1,26
2018,Marzo,3,3/1/2018,República de Irlanda,225,393,0,618
2018,Marzo,3,3/1/2018,Islandia,16,18,0,34
2018,Marzo,3,3/1/2018,Israel,608,1113,0,1721
2018,Marzo,3,3/1/2018,Italia,1042,2459,0,3501
2018,Marzo,3,3/1/2018,Jamaica,48,51,0,99
2018,Marzo,3,3/1/2018,Japón,298,636,0,934
2018,Marzo,3,3/1/2018,Jordania,4,7,0,11
2018,Marzo,3,3/1/2018,Kazajistán,8,1,0,9
2018,Marzo,3,3/1/2018,Kenia,13,18,0,31
2018,Marzo,3,3/1/2018,Kirguistán,0,2,0,2
2018,Marzo,3,3/1/2018,Kuwait,3,7,0,10
2018,Marzo,3,3/1/2018,República de Kosovo,2,2,0,4
2018,Marzo,3,3/1/2018,Lesoto,1,0,0,1
2018,Marzo,3,3/1/2018,Letonia,19,39,0,58
2018,Marzo,3,3/1/2018,Lituania,27,40,0,67
2018,Marzo,3,3/1/2018,Líbano,24,36,0,60
2018,Marzo,3,3/1/2018,Liberia,1,0,0,1
2018,Marzo,3,3/1/2018,Liechtenstein,5,5,0,10
2018,Marzo,3,3/1/2018,Luxemburgo,14,31,0,45
2018,Marzo,3,3/1/2018,Macedonia,1,3,0,4
2018,Marzo,3,3/1/2018,Madagascar,0,1,0,1
2018,Marzo,3,3/1/2018,Malasia,31,34,0,65
2018,Marzo,3,3/1/2018,Malawi,1,2,0,3
2018,Marzo,3,3/1/2018,Maldivas,1,0,0,1
2018,Marzo,3,3/1/2018,Malí,0,4,0,4
2018,Marzo,3,3/1/2018,Malta,5,15,0,20
2018,Marzo,3,3/1/2018,Marruecos,12,14,0,26
2018,Marzo,3,3/1/2018,Mauricio,4,2,0,6
2018,Marzo,3,3/1/2018,Mauritania,0,1,0,1
2018,Marzo,3,3/1/2018,México,6320,10396,2,16718
2018,Marzo,3,3/1/2018,República de Moldavia,6,3,0,9
2018,Marzo,3,3/1/2018,Mónaco,1,7,0,8
2018,Marzo,3,3/1/2018,Montenegro,2,7,0,9
2018,Marzo,3,3/1/2018,Mozambique,2,0,0,2
2018,Marzo,3,3/1/2018,Myanmar,1,23,0,24
2018,Marzo,3,3/1/2018,Namibia,1,0,0,1
2018,Marzo,3,3/1/2018,Nepal,2,8,0,10
2018,Marzo,3,3/1/2018,Nicaragua,236,204,0,440
2018,Marzo,3,3/1/2018,Nigeria,5,16,0,21
2018,Marzo,3,3/1/2018,Noruega,224,246,0,470
2018,Marzo,3,3/1/2018,Nueva Zelanda,106,177,0,283
2018,Marzo,3,3/1/2018,Omán,1,2,0,3
2018,Marzo,3,3/1/2018,Papúa Nueva Guinea,0,2,0,2
2018,Marzo,3,3/1/2018,Pakistán,12,25,0,37
2018,Marzo,3,3/1/2018,Panamá,3641,3642,0,7283
2018,Marzo,3,3/1/2018,Paraguay,388,327,0,715
2018,Marzo,3,3/1/2018,Perú,5821,6844,0,12665
2018,Marzo,3,3/1/2018,Palestina,1,4,0,5
2018,Marzo,3,3/1/2018,Polonia,243,360,0,603
2018,Marzo,3,3/1/2018,Portugal,395,656,0,1051
2018,Marzo,3,3/1/2018,Puerto Rico/Territorio de Estados Unidos,0,1,0,1
2018,Marzo,3,3/1/2018,Qatar,0,2,0,2
2018,Marzo,3,3/1/2018,Reino Unido de Gran Bretaña e Irlanda del Norte,1856,3200,0,5056
2018,Marzo,3,3/1/2018,Federación de Rusia,220,274,0,494
2018,Marzo,3,3/1/2018,República Dominicana,1101,1148,0,2249
2018,Marzo,3,3/1/2018,Rumania,99,134,0,233
2018,Marzo,3,3/1/2018,Rwanda,0,1,0,1
2018,Marzo,3,3/1/2018,San Cristóbal y Nevis,3,7,0,10
2018,Marzo,3,3/1/2018,San Marino,1,3,0,4
2018,Marzo,3,3/1/2018,San  Vicente y las Granadinas,2,1,0,3
2018,Marzo,3,3/1/2018,Santa Lucia,3,12,0,15
2018,Marzo,3,3/1/2018,Santa Sede/Ciudad del Vaticano,1,0,0,1
2018,Marzo,3,3/1/2018,Senegal,2,7,0,9
2018,Marzo,3,3/1/2018,Serbia,12,28,0,40
2018,Marzo,3,3/1/2018,Sierra Leona,0,1,0,1
2018,Marzo,3,3/1/2018,Singapur,36,43,0,79
2018,Marzo,3,3/1/2018,República Árabe Siria,1,5,0,6
2018,Marzo,3,3/1/2018,Sri Lanka,1,6,0,7
2018,Marzo,3,3/1/2018,Sudáfrica,56,80,0,136
2018,Marzo,3,3/1/2018,Sudán,2,1,0,3
2018,Marzo,3,3/1/2018,Suecia,391,479,0,870
2018,Marzo,3,3/1/2018,Suiza,770,1033,0,1803
2018,Marzo,3,3/1/2018,Surinam,17,27,0,44
2018,Marzo,3,3/1/2018,Suazilandia,2,0,0,2
2018,Marzo,3,3/1/2018,Taiwán,152,161,0,313
2018,Marzo,3,3/1/2018,Tailandia,25,28,0,53
2018,Marzo,3,3/1/2018,Tanzania,5,4,0,9
2018,Marzo,3,3/1/2018,Togo,1,2,0,3
2018,Marzo,3,3/1/2018,Trinidad y Tobago,40,93,0,133
2018,Marzo,3,3/1/2018,Túnez,4,8,0,12
2018,Marzo,3,3/1/2018,Turquía,261,484,0,745
2018,Marzo,3,3/1/2018,Ucrania,38,55,0,93
2018,Marzo,3,3/1/2018,Uganda,2,2,0,4
2018,Marzo,3,3/1/2018,Uruguay,766,913,22,1701
2018,Marzo,3,3/1/2018,Uzbekistán,0,7,0,7
2018,Marzo,3,3/1/2018,Vanuatu,1,0,0,1
2018,Marzo,3,3/1/2018,Venezuela,53271,65184,0,118455
2018,Marzo,3,3/1/2018,Vietnam,18,14,0,32
2018,Marzo,3,3/1/2018,República Árabe de Yemen,1,4,0,5
2018,Marzo,3,3/1/2018,Zambia,3,0,0,3
2018,Marzo,3,3/1/2018,Zimbabue,1,4,0,5
2018,Marzo,3,3/1/2018,Refugiado,3,12,0,15
2018,Marzo,3,3/1/2018,Desconocido,94,149,0,243
2018,Abril,4,4/1/2018,Afganistán,0,1,0,1
2018,Abril,4,4/1/2018,Albania,3,3,0,6
2018,Abril,4,4/1/2018,Alemania,2017,3127,0,5144
2018,Abril,4,4/1/2018,Andorra,2,7,0,9
2018,Abril,4,4/1/2018,Antigua y Barbuda,1,6,0,7
2018,Abril,4,4/1/2018,Países Bajos,2041,2604,0,4645
2018,Abril,4,4/1/2018,Arabia Saudita,1,6,0,7
2018,Abril,4,4/1/2018,Argelia,1,5,0,6
2018,Abril,4,4/1/2018,Argentina,10653,11046,1,21700
2018,Abril,4,4/1/2018,República de Armenia,3,3,0,6
2018,Abril,4,4/1/2018,Aruba,2,0,0,2
2018,Abril,4,4/1/2018,Australia,467,721,0,1188
2018,Abril,4,4/1/2018,Austria,193,296,0,489
2018,Abril,4,4/1/2018,Azerbaiyán,2,2,0,4
2018,Abril,4,4/1/2018,Bahamas,17,18,0,35
2018,Abril,4,4/1/2018,Bahréin,0,1,0,1
2018,Abril,4,4/1/2018,Bangladesh,0,5,0,5
2018,Abril,4,4/1/2018,Barbados,14,19,0,33
2018,Abril,4,4/1/2018,República de Belarús,3,7,0,10
2018,Abril,4,4/1/2018,Bélgica,262,543,0,805
2018,Abril,4,4/1/2018,Belice,8,21,0,29
2018,Abril,4,4/1/2018,Bermudas/Territorio Británico de Ultramar,1,1,0,2
2018,Abril,4,4/1/2018,Bolivia,742,840,0,1582
2018,Abril,4,4/1/2018,Bosnia y Herzegovina,6,12,0,18
2018,Abril,4,4/1/2018,Brasil,8418,9078,8,17504
2018,Abril,4,4/1/2018,Bulgaria,69,74,0,143
2018,Abril,4,4/1/2018,Burkina Faso,0,2,0,2
2018,Abril,4,4/1/2018,Cabo Verde,2,10,0,12
2018,Abril,4,4/1/2018,Islas Caimán/Territorio Británico de Ultramar,1,3,0,4
2018,Abril,4,4/1/2018,Camerún,1,1,0,2
2018,Abril,4,4/1/2018,Canadá,1712,2858,1,4571
2018,Abril,4,4/1/2018,España,3995,7480,1,11476
2018,Abril,4,4/1/2018,República Democrática del Congo,3,5,0,8
2018,Abril,4,4/1/2018,República de Corea,268,509,0,777
2018,Abril,4,4/1/2018,Costa de Marfil,3,0,0,3
2018,Abril,4,4/1/2018,Costa Rica,2022,2481,0,4503
2018,Abril,4,4/1/2018,Croacia,25,65,0,90
2018,Abril,4,4/1/2018,Cuba,301,431,0,732
2018,Abril,4,4/1/2018,Curazao,0,2,0,2
2018,Abril,4,4/1/2018,República Checa,100,146,0,246
2018,Abril,4,4/1/2018,Chile,5401,6640,1,12042
2018,Abril,4,4/1/2018,China,492,1062,0,1554
2018,Abril,4,4/1/2018,Chipre,2,5,0,7
2018,Abril,4,4/1/2018,Dinamarca,161,243,0,404
2018,Abril,4,4/1/2018,Dominica,3,7,0,10
2018,Abril,4,4/1/2018,Ecuador,5276,7257,1,12534
2018,Abril,4,4/1/2018,Egipto,4,14,0,18
2018,Abril,4,4/1/2018,El Salvador,1025,1282,0,2307
2018,Abril,4,4/1/2018,Emiratos Árabes,4,13,0,17
2018,Abril,4,4/1/2018,Eslovaquia,73,97,0,170
2018,Abril,4,4/1/2018,Eslovenia,39,73,0,112
2018,Abril,4,4/1/2018,Estados Unidos de América,16711,29937,1,46649
2018,Abril,4,4/1/2018,Estonia,12,16,0,28
2018,Abril,4,4/1/2018,Etiopia,0,6,0,6
2018,Abril,4,4/1/2018,Filipinas,75,267,0,342
2018,Abril,4,4/1/2018,Finlandia,60,98,0,158
2018,Abril,4,4/1/2018,Francia,2679,3782,0,6461
2018,Abril,4,4/1/2018,Gabón,0,1,0,1
2018,Abril,4,4/1/2018,Georgia,3,3,0,6
2018,Abril,4,4/1/2018,Ghana,3,17,0,20
2018,Abril,4,4/1/2018,Granada,1,7,0,8
2018,Abril,4,4/1/2018,Grecia,41,108,0,149
2018,Abril,4,4/1/2018,Guatemala,603,1204,0,1807
2018,Abril,4,4/1/2018,Guyana,23,31,0,54
2018,Abril,4,4/1/2018,Haití,16,35,0,51
2018,Abril,4,4/1/2018,Honduras,397,550,0,947
2018,Abril,4,4/1/2018,Hong Kong,8,16,0,24
2018,Abril,4,4/1/2018,Hungría,66,93,0,159
2018,Abril,4,4/1/2018,India,115,535,0,650
2018,Abril,4,4/1/2018,Indonesia,13,35,0,48
2018,Abril,4,4/1/2018,Iraq,1,2,0,3
2018,Abril,4,4/1/2018,Irán,7,17,0,24
2018,Abril,4,4/1/2018,República de Irlanda,187,315,0,502
2018,Abril,4,4/1/2018,Islandia,7,16,0,23
2018,Abril,4,4/1/2018,Israel,894,1680,1,2575
2018,Abril,4,4/1/2018,Italia,961,2249,0,3210
2018,Abril,4,4/1/2018,Jamaica,45,56,0,101
2018,Abril,4,4/1/2018,Japón,199,556,0,755
2018,Abril,4,4/1/2018,Jordania,6,7,0,13
2018,Abril,4,4/1/2018,Kazajistán,2,2,0,4
2018,Abril,4,4/1/2018,Kenia,6,15,0,21
2018,Abril,4,4/1/2018,Kuwait,0,7,0,7
2018,Abril,4,4/1/2018,República de Kosovo,1,0,0,1
2018,Abril,4,4/1/2018,Letonia,9,19,0,28
2018,Abril,4,4/1/2018,Lituania,29,28,0,57
2018,Abril,4,4/1/2018,Líbano,18,24,0,42
2018,Abril,4,4/1/2018,Liberia,1,0,0,1
2018,Abril,4,4/1/2018,Liechtenstein,1,3,0,4
2018,Abril,4,4/1/2018,Luxemburgo,10,12,0,22
2018,Abril,4,4/1/2018,Macedonia,2,4,0,6
2018,Abril,4,4/1/2018,Madagascar,2,1,0,3
2018,Abril,4,4/1/2018,Malasia,39,53,1,93
2018,Abril,4,4/1/2018,Malawi,0,2,0,2
2018,Abril,4,4/1/2018,Maldivas,1,0,0,1
2018,Abril,4,4/1/2018,Malí,0,1,0,1
2018,Abril,4,4/1/2018,Malta,1,5,0,6
2018,Abril,4,4/1/2018,Marruecos,15,20,0,35
2018,Abril,4,4/1/2018,Mauricio,0,6,0,6
2018,Abril,4,4/1/2018,México,5251,9886,0,15137
2018,Abril,4,4/1/2018,República de Moldavia,2,3,0,5
2018,Abril,4,4/1/2018,Mónaco,1,1,0,2
2018,Abril,4,4/1/2018,Mongolia,1,0,0,1
2018,Abril,4,4/1/2018,Montenegro,1,5,0,6
2018,Abril,4,4/1/2018,Mozambique,1,3,0,4
2018,Abril,4,4/1/2018,Myanmar,1,0,0,1
2018,Abril,4,4/1/2018,Namibia,1,1,0,2
2018,Abril,4,4/1/2018,Nepal,2,4,0,6
2018,Abril,4,4/1/2018,Nicaragua,131,178,0,309
2018,Abril,4,4/1/2018,Nigeria,1,6,0,7
2018,Abril,4,4/1/2018,Noruega,112,150,0,262
2018,Abril,4,4/1/2018,Nueva Zelanda,109,170,0,279
2018,Abril,4,4/1/2018,Omán,0,1,0,1
2018,Abril,4,4/1/2018,Pakistán,3,14,0,17
2018,Abril,4,4/1/2018,Panamá,3630,3794,0,7424
2018,Abril,4,4/1/2018,Paraguay,356,290,0,646
2018,Abril,4,4/1/2018,Perú,5462,6610,0,12072
2018,Abril,4,4/1/2018,Palestina,2,1,0,3
2018,Abril,4,4/1/2018,Polonia,212,267,0,479
2018,Abril,4,4/1/2018,Portugal,321,682,0,1003
2018,Abril,4,4/1/2018,Qatar,1,5,0,6
2018,Abril,4,4/1/2018,Reino Unido de Gran Bretaña e Irlanda del Norte,1587,2692,0,4279
2018,Abril,4,4/1/2018,República CentroÁfricana,1,0,0,1
2018,Abril,4,4/1/2018,Federación de Rusia,209,259,0,468
2018,Abril,4,4/1/2018,República Dominicana,833,902,0,1735
2018,Abril,4,4/1/2018,Rumania,108,95,0,203
2018,Abril,4,4/1/2018,Rwanda,1,1,0,2
2018,Abril,4,4/1/2018,San Cristóbal y Nevis,3,4,0,7
2018,Abril,4,4/1/2018,San Marino,1,2,0,3
2018,Abril,4,4/1/2018,San  Vicente y las Granadinas,0,3,0,3
2018,Abril,4,4/1/2018,Santa Lucia,3,8,0,11
2018,Abril,4,4/1/2018,Santa Sede/Ciudad del Vaticano,0,2,0,2
2018,Abril,4,4/1/2018,Senegal,0,3,0,3
2018,Abril,4,4/1/2018,Serbia,12,33,0,45
2018,Abril,4,4/1/2018,Seychelles,0,1,0,1
2018,Abril,4,4/1/2018,Sierra Leona,0,1,0,1
2018,Abril,4,4/1/2018,Singapur,23,33,0,56
2018,Abril,4,4/1/2018,República Árabe Siria,0,5,0,5
2018,Abril,4,4/1/2018,Sri Lanka,3,4,0,7
2018,Abril,4,4/1/2018,Sudáfrica,23,71,0,94
2018,Abril,4,4/1/2018,Sudán,0,2,0,2
2018,Abril,4,4/1/2018,Suecia,261,369,0,630
2018,Abril,4,4/1/2018,Suiza,620,901,0,1521
2018,Abril,4,4/1/2018,Surinam,26,28,0,54
2018,Abril,4,4/1/2018,Taiwán,83,122,0,205
2018,Abril,4,4/1/2018,Tailandia,41,33,0,74
2018,Abril,4,4/1/2018,Tanzania,0,1,0,1
2018,Abril,4,4/1/2018,Togo,0,1,0,1
2018,Abril,4,4/1/2018,Trinidad y Tobago,45,79,0,124
2018,Abril,4,4/1/2018,Túnez,4,9,0,13
2018,Abril,4,4/1/2018,Turquía,210,447,0,657
2018,Abril,4,4/1/2018,Ucrania,29,48,0,77
2018,Abril,4,4/1/2018,Uganda,2,1,0,3
2018,Abril,4,4/1/2018,Uruguay,837,1003,96,1936
2018,Abril,4,4/1/2018,Uzbekistán,1,0,0,1
2018,Abril,4,4/1/2018,Venezuela,56119,67022,3,123144
2018,Abril,4,4/1/2018,Vietnam,6,6,0,12
2018,Abril,4,4/1/2018,Islas Vírgenes Británicas/Territorio Británico de Ultramar,0,1,0,1
2018,Abril,4,4/1/2018,República Árabe de Yemen,0,4,0,4
2018,Abril,4,4/1/2018,Zambia,1,1,0,2
2018,Abril,4,4/1/2018,Zimbabue,0,4,0,4
2018,Abril,4,4/1/2018,Anguila/Territorio Británico de Ultramar,1,0,0,1
2018,Abril,4,4/1/2018,Refugiado,10,7,0,17
2018,Abril,4,4/1/2018,Desconocido,117,207,0,324
2018,Mayo,5,5/1/2018,Albania,2,3,0,5
2018,Mayo,5,5/1/2018,Alemania,1840,2817,0,4657
2018,Mayo,5,5/1/2018,Andorra,1,9,0,10
2018,Mayo,5,5/1/2018,Antigua y Barbuda,1,10,0,11
2018,Mayo,5,5/1/2018,Países Bajos,1729,2282,0,4011
2018,Mayo,5,5/1/2018,Arabia Saudita,0,7,0,7
2018,Mayo,5,5/1/2018,Argelia,4,2,0,6
2018,Mayo,5,5/1/2018,Argentina,8179,8600,1,16780
2018,Mayo,5,5/1/2018,República de Armenia,3,2,0,5
2018,Mayo,5,5/1/2018,Australia,466,807,1,1274
2018,Mayo,5,5/1/2018,Austria,169,309,0,478
2018,Mayo,5,5/1/2018,Azerbaiyán,2,8,0,10
2018,Mayo,5,5/1/2018,Bahamas,5,24,0,29
2018,Mayo,5,5/1/2018,Bahréin,0,1,0,1
2018,Mayo,5,5/1/2018,Bangladesh,4,1,0,5
2018,Mayo,5,5/1/2018,Barbados,21,24,0,45
2018,Mayo,5,5/1/2018,República de Belarús,9,1,0,10
2018,Mayo,5,5/1/2018,Bélgica,231,455,0,686
2018,Mayo,5,5/1/2018,Belice,8,10,0,18
2018,Mayo,5,5/1/2018,Bermudas/Territorio Británico de Ultramar,2,2,0,4
2018,Mayo,5,5/1/2018,Bolivia,800,674,1,1475
2018,Mayo,5,5/1/2018,Bosnia y Herzegovina,6,8,0,14
2018,Mayo,5,5/1/2018,Botsuana,0,1,0,1
2018,Mayo,5,5/1/2018,Brasil,7168,8139,0,15307
2018,Mayo,5,5/1/2018,Brunei Darussalam,1,0,0,1
2018,Mayo,5,5/1/2018,Bulgaria,51,49,0,100
2018,Mayo,5,5/1/2018,Burkina Faso,1,2,0,3
2018,Mayo,5,5/1/2018,Bután,0,1,0,1
2018,Mayo,5,5/1/2018,Islas Caimán/Territorio Británico de Ultramar,6,3,0,9
2018,Mayo,5,5/1/2018,Camboya,0,1,0,1
2018,Mayo,5,5/1/2018,Camerún,1,6,0,7
2018,Mayo,5,5/1/2018,Canadá,1625,2427,0,4052
2018,Mayo,5,5/1/2018,España,3776,7075,0,10851
2018,Mayo,5,5/1/2018,República Del Congo,0,1,0,1
2018,Mayo,5,5/1/2018,República Democrática del Congo,7,4,0,11
2018,Mayo,5,5/1/2018,República de Corea,236,460,0,696
2018,Mayo,5,5/1/2018,Costa de Marfil,0,2,0,2
2018,Mayo,5,5/1/2018,Costa Rica,1703,2249,0,3952
2018,Mayo,5,5/1/2018,Croacia,13,55,0,68
2018,Mayo,5,5/1/2018,Cuba,242,420,0,662
2018,Mayo,5,5/1/2018,Curazao,0,1,0,1
2018,Mayo,5,5/1/2018,República Checa,58,111,0,169
2018,Mayo,5,5/1/2018,Chile,5353,6870,0,12223
2018,Mayo,5,5/1/2018,China,515,1129,0,1644
2018,Mayo,5,5/1/2018,Chipre,5,8,0,13
2018,Mayo,5,5/1/2018,Dinamarca,115,184,0,299
2018,Mayo,5,5/1/2018,Dominica,3,6,0,9
2018,Mayo,5,5/1/2018,Ecuador,4901,6035,0,10936
2018,Mayo,5,5/1/2018,Egipto,8,32,0,40
2018,Mayo,5,5/1/2018,El Salvador,1049,1269,0,2318
2018,Mayo,5,5/1/2018,Emiratos Árabes,2,11,0,13
2018,Mayo,5,5/1/2018,Eslovaquia,28,46,0,74
2018,Mayo,5,5/1/2018,Eslovenia,10,20,0,30
2018,Mayo,5,5/1/2018,Estados Unidos de América,19604,31957,3,51564
2018,Mayo,5,5/1/2018,Estonia,10,9,0,19
2018,Mayo,5,5/1/2018,Etiopia,0,2,0,2
2018,Mayo,5,5/1/2018,Islas Fiji,1,1,0,2
2018,Mayo,5,5/1/2018,Filipinas,62,297,0,359
2018,Mayo,5,5/1/2018,Finlandia,69,81,0,150
2018,Mayo,5,5/1/2018,Francia,1993,3046,0,5039
2018,Mayo,5,5/1/2018,Gabón,1,0,0,1
2018,Mayo,5,5/1/2018,Georgia,1,8,0,9
2018,Mayo,5,5/1/2018,Ghana,4,5,0,9
2018,Mayo,5,5/1/2018,Granada,3,4,0,7
2018,Mayo,5,5/1/2018,Grecia,28,98,0,126
2018,Mayo,5,5/1/2018,Guatemala,590,1096,0,1686
2018,Mayo,5,5/1/2018,Guyana,8,22,0,30
2018,Mayo,5,5/1/2018,Haití,18,27,0,45
2018,Mayo,5,5/1/2018,Honduras,383,470,0,853
2018,Mayo,5,5/1/2018,Hong Kong,9,16,0,25
2018,Mayo,5,5/1/2018,Hungría,40,73,0,113
2018,Mayo,5,5/1/2018,India,129,606,1,736
2018,Mayo,5,5/1/2018,Indonesia,32,55,0,87
2018,Mayo,5,5/1/2018,Irán,10,19,0,29
2018,Mayo,5,5/1/2018,República de Irlanda,197,306,0,503
2018,Mayo,5,5/1/2018,Islandia,9,11,0,20
2018,Mayo,5,5/1/2018,Israel,472,995,0,1467
2018,Mayo,5,5/1/2018,Italia,810,2043,1,2854
2018,Mayo,5,5/1/2018,Jamaica,34,54,0,88
2018,Mayo,5,5/1/2018,Japón,160,573,0,733
2018,Mayo,5,5/1/2018,Jordania,2,3,0,5
2018,Mayo,5,5/1/2018,Kazajistán,10,13,0,23
2018,Mayo,5,5/1/2018,Kenia,6,12,0,18
2018,Mayo,5,5/1/2018,Kirguistán,2,0,0,2
2018,Mayo,5,5/1/2018,Kuwait,2,2,0,4
2018,Mayo,5,5/1/2018,República de Kosovo,5,1,0,6
2018,Mayo,5,5/1/2018,Letonia,7,9,0,16
2018,Mayo,5,5/1/2018,Lituania,25,39,0,64
2018,Mayo,5,5/1/2018,Líbano,18,39,0,57
2018,Mayo,5,5/1/2018,Libia,0,1,0,1
2018,Mayo,5,5/1/2018,Liechtenstein,0,3,0,3
2018,Mayo,5,5/1/2018,Luxemburgo,3,10,0,13
2018,Mayo,5,5/1/2018,Macedonia,1,3,0,4
2018,Mayo,5,5/1/2018,Madagascar,3,0,0,3
2018,Mayo,5,5/1/2018,Malasia,37,39,1,77
2018,Mayo,5,5/1/2018,Malí,1,1,0,2
2018,Mayo,5,5/1/2018,Malta,3,7,0,10
2018,Mayo,5,5/1/2018,Marruecos,6,12,0,18
2018,Mayo,5,5/1/2018,Mauricio,0,8,0,8
2018,Mayo,5,5/1/2018,México,5623,9491,1,15115
2018,Mayo,5,5/1/2018,República de Moldavia,2,2,0,4
2018,Mayo,5,5/1/2018,Mónaco,1,2,0,3
2018,Mayo,5,5/1/2018,Mongolia,4,11,0,15
2018,Mayo,5,5/1/2018,Montenegro,0,5,0,5
2018,Mayo,5,5/1/2018,Mozambique,1,4,0,5
2018,Mayo,5,5/1/2018,Myanmar,3,12,0,15
2018,Mayo,5,5/1/2018,Nepal,3,7,0,10
2018,Mayo,5,5/1/2018,Nicaragua,138,164,0,302
2018,Mayo,5,5/1/2018,Nigeria,5,17,0,22
2018,Mayo,5,5/1/2018,Noruega,112,131,0,243
2018,Mayo,5,5/1/2018,Nueva Zelanda,95,173,0,268
2018,Mayo,5,5/1/2018,Pakistán,3,20,0,23
2018,Mayo,5,5/1/2018,Panamá,3047,3376,1,6424
2018,Mayo,5,5/1/2018,Paraguay,420,337,0,757
2018,Mayo,5,5/1/2018,Perú,5917,6679,0,12596
2018,Mayo,5,5/1/2018,Palestina,0,1,0,1
2018,Mayo,5,5/1/2018,Polonia,173,241,0,414
2018,Mayo,5,5/1/2018,Portugal,233,536,0,769
2018,Mayo,5,5/1/2018,Qatar,0,1,0,1
2018,Mayo,5,5/1/2018,Reino Unido de Gran Bretaña e Irlanda del Norte,1435,2592,0,4027
2018,Mayo,5,5/1/2018,República CentroÁfricana,1,0,0,1
2018,Mayo,5,5/1/2018,Federación de Rusia,190,234,0,424
2018,Mayo,5,5/1/2018,República Dominicana,880,1015,0,1895
2018,Mayo,5,5/1/2018,Rumania,146,112,0,258
2018,Mayo,5,5/1/2018,Rwanda,0,1,0,1
2018,Mayo,5,5/1/2018,San Cristóbal y Nevis,2,3,0,5
2018,Mayo,5,5/1/2018,San  Vicente y las Granadinas,12,12,0,24
2018,Mayo,5,5/1/2018,Santa Lucia,7,10,0,17
2018,Mayo,5,5/1/2018,Senegal,0,3,0,3
2018,Mayo,5,5/1/2018,Serbia,13,30,0,43
2018,Mayo,5,5/1/2018,Singapur,38,45,0,83
2018,Mayo,5,5/1/2018,República Árabe Siria,0,2,0,2
2018,Mayo,5,5/1/2018,Sri Lanka,1,11,0,12
2018,Mayo,5,5/1/2018,Sudáfrica,28,56,0,84
2018,Mayo,5,5/1/2018,Sudán,1,2,0,3
2018,Mayo,5,5/1/2018,Suecia,181,285,0,466
2018,Mayo,5,5/1/2018,Suiza,445,768,0,1213
2018,Mayo,5,5/1/2018,Surinam,23,46,0,69
2018,Mayo,5,5/1/2018,Taiwán,84,109,0,193
2018,Mayo,5,5/1/2018,Tailandia,16,25,0,41
2018,Mayo,5,5/1/2018,Tanzania,0,3,0,3
2018,Mayo,5,5/1/2018,Trinidad y Tobago,40,89,0,129
2018,Mayo,5,5/1/2018,Túnez,1,8,0,9
2018,Mayo,5,5/1/2018,Turquía,166,341,0,507
2018,Mayo,5,5/1/2018,Ucrania,22,58,0,80
2018,Mayo,5,5/1/2018,Uganda,1,1,0,2
2018,Mayo,5,5/1/2018,Uruguay,750,945,24,1719
2018,Mayo,5,5/1/2018,Uzbekistán,1,1,0,2
2018,Mayo,5,5/1/2018,Venezuela,53934,60466,1,114401
2018,Mayo,5,5/1/2018,Vietnam,6,7,0,13
2018,Mayo,5,5/1/2018,República Árabe de Yemen,0,1,0,1
2018,Mayo,5,5/1/2018,Zambia,1,0,0,1
2018,Mayo,5,5/1/2018,Zimbabue,2,3,0,5
2018,Mayo,5,5/1/2018,Anguila/Territorio Británico de Ultramar,0,1,0,1
2018,Mayo,5,5/1/2018,Refugiado,4,2,0,6
2018,Mayo,5,5/1/2018,Desconocido,88,166,0,254
2018,Junio,6,6/1/2018,Afganistán,0,2,0,2
2018,Junio,6,6/1/2018,Albania,3,5,0,8
2018,Junio,6,6/1/2018,Alemania,1908,2652,0,4560
2018,Junio,6,6/1/2018,Andorra,1,7,0,8
2018,Junio,6,6/1/2018,Antigua y Barbuda,5,7,0,12
2018,Junio,6,6/1/2018,Países Bajos,1704,2299,3,4006
2018,Junio,6,6/1/2018,Arabia Saudita,1,18,0,19
2018,Junio,6,6/1/2018,Argelia,2,7,0,9
2018,Junio,6,6/1/2018,Argentina,7449,7316,1,14766
2018,Junio,6,6/1/2018,República de Armenia,1,1,0,2
2018,Junio,6,6/1/2018,Australia,513,854,0,1367
2018,Junio,6,6/1/2018,Austria,144,239,0,383
2018,Junio,6,6/1/2018,Azerbaiyán,2,3,0,5
2018,Junio,6,6/1/2018,Bahamas,15,18,0,33
2018,Junio,6,6/1/2018,Bahréin,0,1,0,1
2018,Junio,6,6/1/2018,Bangladesh,3,2,0,5
2018,Junio,6,6/1/2018,Barbados,21,20,0,41
2018,Junio,6,6/1/2018,República de Belarús,5,3,0,8
2018,Junio,6,6/1/2018,Bélgica,366,558,0,924
2018,Junio,6,6/1/2018,Belice,9,15,0,24
2018,Junio,6,6/1/2018,Benín,1,3,0,4
2018,Junio,6,6/1/2018,Bermudas/Territorio Británico de Ultramar,0,4,0,4
2018,Junio,6,6/1/2018,Bolivia,817,887,3,1707
2018,Junio,6,6/1/2018,Bosnia y Herzegovina,2,8,0,10
2018,Junio,6,6/1/2018,Botsuana,1,0,0,1
2018,Junio,6,6/1/2018,Brasil,6528,7398,2,13928
2018,Junio,6,6/1/2018,Brunei Darussalam,1,1,0,2
2018,Junio,6,6/1/2018,Bulgaria,35,31,0,66
2018,Junio,6,6/1/2018,Burkina Faso,0,1,0,1
2018,Junio,6,6/1/2018,Burundi,0,2,0,2
2018,Junio,6,6/1/2018,Bután,1,0,0,1
2018,Junio,6,6/1/2018,Cabo Verde,2,2,0,4
2018,Junio,6,6/1/2018,Islas Caimán/Territorio Británico de Ultramar,13,7,0,20
2018,Junio,6,6/1/2018,Camerún,6,3,0,9
2018,Junio,6,6/1/2018,Canadá,1557,2354,0,3911
2018,Junio,6,6/1/2018,España,4286,7099,0,11385
2018,Junio,6,6/1/2018,República Democrática del Congo,5,3,0,8
2018,Junio,6,6/1/2018,República de Corea,300,482,0,782
2018,Junio,6,6/1/2018,Costa de Marfil,1,3,0,4
2018,Junio,6,6/1/2018,Costa Rica,1801,2114,0,3915
2018,Junio,6,6/1/2018,Croacia,17,49,0,66
2018,Junio,6,6/1/2018,Cuba,280,541,0,821
2018,Junio,6,6/1/2018,República Checa,62,104,0,166
2018,Junio,6,6/1/2018,Chile,5028,6102,0,11130
2018,Junio,6,6/1/2018,China,509,1073,0,1582
2018,Junio,6,6/1/2018,Chipre,10,8,0,18
2018,Junio,6,6/1/2018,Dinamarca,167,267,0,434
2018,Junio,6,6/1/2018,Dominica,5,8,0,13
2018,Junio,6,6/1/2018,Ecuador,4327,6204,1,10532
2018,Junio,6,6/1/2018,Egipto,8,27,0,35
2018,Junio,6,6/1/2018,El Salvador,866,1141,0,2007
2018,Junio,6,6/1/2018,Emiratos Árabes,8,14,0,22
2018,Junio,6,6/1/2018,Eslovaquia,30,25,0,55
2018,Junio,6,6/1/2018,Eslovenia,11,23,0,34
2018,Junio,6,6/1/2018,Estados Unidos de América,27439,39116,0,66555
2018,Junio,6,6/1/2018,Estonia,14,12,0,26
2018,Junio,6,6/1/2018,Etiopia,3,17,0,20
2018,Junio,6,6/1/2018,Filipinas,62,215,0,277
2018,Junio,6,6/1/2018,Finlandia,71,70,0,141
2018,Junio,6,6/1/2018,Francia,2043,3045,0,5088
2018,Junio,6,6/1/2018,Gabón,1,1,0,2
2018,Junio,6,6/1/2018,Georgia,3,0,0,3
2018,Junio,6,6/1/2018,Ghana,1,4,0,5
2018,Junio,6,6/1/2018,Granada,2,6,0,8
2018,Junio,6,6/1/2018,Grecia,28,81,0,109
2018,Junio,6,6/1/2018,Guatemala,857,1184,1,2042
2018,Junio,6,6/1/2018,Guyana,14,17,0,31
2018,Junio,6,6/1/2018,Guinea Ecuatorial,1,2,0,3
2018,Junio,6,6/1/2018,Haití,21,36,0,57
2018,Junio,6,6/1/2018,Honduras,362,478,0,840
2018,Junio,6,6/1/2018,Hong Kong,19,11,0,30
2018,Junio,6,6/1/2018,Hungría,32,62,0,94
2018,Junio,6,6/1/2018,India,144,568,1,713
2018,Junio,6,6/1/2018,Indonesia,30,46,0,76
2018,Junio,6,6/1/2018,Iraq,1,3,0,4
2018,Junio,6,6/1/2018,Irán,4,22,1,27
2018,Junio,6,6/1/2018,República de Irlanda,258,383,0,641
2018,Junio,6,6/1/2018,Islandia,6,10,0,16
2018,Junio,6,6/1/2018,Israel,256,671,0,927
2018,Junio,6,6/1/2018,Italia,961,2205,0,3166
2018,Junio,6,6/1/2018,Jamaica,37,70,0,107
2018,Junio,6,6/1/2018,Japón,238,586,0,824
2018,Junio,6,6/1/2018,Jordania,2,7,0,9
2018,Junio,6,6/1/2018,Kazajistán,1,2,0,3
2018,Junio,6,6/1/2018,Kenia,8,9,0,17
2018,Junio,6,6/1/2018,Kirguistán,0,3,0,3
2018,Junio,6,6/1/2018,Kuwait,4,5,0,9
2018,Junio,6,6/1/2018,República de Kosovo,0,2,0,2
2018,Junio,6,6/1/2018,Lesoto,0,1,0,1
2018,Junio,6,6/1/2018,Letonia,8,19,0,27
2018,Junio,6,6/1/2018,Lituania,39,28,0,67
2018,Junio,6,6/1/2018,Líbano,20,32,0,52
2018,Junio,6,6/1/2018,Liechtenstein,0,1,0,1
2018,Junio,6,6/1/2018,Luxemburgo,18,14,0,32
2018,Junio,6,6/1/2018,Macedonia,1,4,0,5
2018,Junio,6,6/1/2018,Madagascar,0,1,0,1
2018,Junio,6,6/1/2018,Malasia,31,27,0,58
2018,Junio,6,6/1/2018,Malawi,0,3,0,3
2018,Junio,6,6/1/2018,Maldivas,1,0,0,1
2018,Junio,6,6/1/2018,Malta,2,9,0,11
2018,Junio,6,6/1/2018,Marruecos,13,18,0,31
2018,Junio,6,6/1/2018,Islas Marshall,1,0,0,1
2018,Junio,6,6/1/2018,Mauricio,5,3,0,8
2018,Junio,6,6/1/2018,Mauritania,0,1,0,1
2018,Junio,6,6/1/2018,México,5543,8687,2,14232
2018,Junio,6,6/1/2018,República de Moldavia,2,2,0,4
2018,Junio,6,6/1/2018,Mónaco,1,0,0,1
2018,Junio,6,6/1/2018,Mongolia,2,0,0,2
2018,Junio,6,6/1/2018,Montenegro,1,3,0,4
2018,Junio,6,6/1/2018,Mozambique,1,2,0,3
2018,Junio,6,6/1/2018,Myanmar,0,4,0,4
2018,Junio,6,6/1/2018,Nepal,5,5,0,10
2018,Junio,6,6/1/2018,Nicaragua,142,139,0,281
2018,Junio,6,6/1/2018,Nigeria,6,13,0,19
2018,Junio,6,6/1/2018,Níger,1,0,0,1
2018,Junio,6,6/1/2018,Noruega,233,266,0,499
2018,Junio,6,6/1/2018,Nueva Zelanda,128,187,0,315
2018,Junio,6,6/1/2018,Omán,0,1,0,1
2018,Junio,6,6/1/2018,Pakistán,2,22,0,24
2018,Junio,6,6/1/2018,Panamá,3433,3514,0,6947
2018,Junio,6,6/1/2018,Paraguay,418,362,0,780
2018,Junio,6,6/1/2018,Perú,5146,6178,0,11324
2018,Junio,6,6/1/2018,Palestina,3,3,0,6
2018,Junio,6,6/1/2018,Polonia,148,216,0,364
2018,Junio,6,6/1/2018,Portugal,213,504,0,717
2018,Junio,6,6/1/2018,Qatar,0,2,0,2
2018,Junio,6,6/1/2018,Reino Unido de Gran Bretaña e Irlanda del Norte,1568,2703,0,4271
2018,Junio,6,6/1/2018,República CentroÁfricana,0,1,0,1
2018,Junio,6,6/1/2018,Federación de Rusia,164,165,0,329
2018,Junio,6,6/1/2018,República Dominicana,757,1021,0,1778
2018,Junio,6,6/1/2018,Rumania,125,95,0,220
2018,Junio,6,6/1/2018,Rwanda,0,1,0,1
2018,Junio,6,6/1/2018,San Cristóbal y Nevis,2,7,0,9
2018,Junio,6,6/1/2018,San  Vicente y las Granadinas,0,9,0,9
2018,Junio,6,6/1/2018,Santa Lucia,7,4,0,11
2018,Junio,6,6/1/2018,Santa Sede/Ciudad del Vaticano,0,1,0,1
2018,Junio,6,6/1/2018,Senegal,0,1,0,1
2018,Junio,6,6/1/2018,Serbia,12,24,0,36
2018,Junio,6,6/1/2018,Sierra Leona,0,2,0,2
2018,Junio,6,6/1/2018,Singapur,37,54,0,91
2018,Junio,6,6/1/2018,República Árabe Siria,1,4,0,5
2018,Junio,6,6/1/2018,Somalia,0,1,0,1
2018,Junio,6,6/1/2018,Sri Lanka,1,5,0,6
2018,Junio,6,6/1/2018,Sudáfrica,33,58,0,91
2018,Junio,6,6/1/2018,Sudán,2,3,0,5
2018,Junio,6,6/1/2018,Suecia,292,432,0,724
2018,Junio,6,6/1/2018,Suiza,548,834,0,1382
2018,Junio,6,6/1/2018,Surinam,6,36,0,42
2018,Junio,6,6/1/2018,Taiwán,81,84,0,165
2018,Junio,6,6/1/2018,República de Tayikistán,1,0,0,1
2018,Junio,6,6/1/2018,Tailandia,17,15,0,32
2018,Junio,6,6/1/2018,Tanzania,3,0,0,3
2018,Junio,6,6/1/2018,Togo,0,2,0,2
2018,Junio,6,6/1/2018,Trinidad y Tobago,52,67,0,119
2018,Junio,6,6/1/2018,Túnez,3,3,0,6
2018,Junio,6,6/1/2018,Turkmenistán,1,0,0,1
2018,Junio,6,6/1/2018,Turquía,195,358,0,553
2018,Junio,6,6/1/2018,Ucrania,42,47,0,89
2018,Junio,6,6/1/2018,Uganda,3,5,0,8
2018,Junio,6,6/1/2018,Uruguay,742,835,7,1584
2018,Junio,6,6/1/2018,Uzbekistán,1,1,0,2
2018,Junio,6,6/1/2018,Venezuela,44573,49862,1,94436
2018,Junio,6,6/1/2018,Vietnam,5,4,0,9
2018,Junio,6,6/1/2018,Islas Vírgenes Británicas/Territorio Británico de Ultramar,1,1,0,2
2018,Junio,6,6/1/2018,República Árabe de Yemen,0,4,0,4
2018,Junio,6,6/1/2018,Zambia,0,2,0,2
2018,Junio,6,6/1/2018,Zimbabue,0,3,0,3
2018,Junio,6,6/1/2018,Refugiado Otro,0,1,0,1
2018,Junio,6,6/1/2018,Refugiado,1,7,0,8
2018,Junio,6,6/1/2018,Desconocido,111,194,0,305
